forlate	negative	1
forlatt	negative	1
oppgivelse	negative	1
abba	positive	1
bortførings	negative	1
avvikende	negative	1
aberrasjon	negative	1
avsky	negative	1
avskyelig	negative	1
evne	positive	1
abject	negative	1
unormal	negative	1
avskaffe	negative	1
avskaffelse	negative	1
avskyelig	negative	1
avskyelig	negative	1
avbryte	negative	1
abort	negative	1
abort	negative	1
ovennevnte	positive	1
slitasje	negative	1
oppheve	negative	1
abscess	negative	1
fravær	negative	1
fraværende	negative	1
fravær	negative	1
fravær	negative	1
absolutt	positive	1
absolutt	positive	1
absorbert	positive	1
absurd	negative	1
absurditet	negative	1
overflod	negative	1
overflod	positive	1
rikelig	positive	1
misbruk	negative	1
abysmal	negative	1
avgrunn	negative	1
faglig	positive	1
akademi	positive	1
akseptabelt	positive	1
aksept	positive	1
tilgjengelig	positive	1
ulykkes	negative	1
utilsiktet	negative	1
utmerkelser	positive	1
innkvartering	positive	1
akkompagnement	positive	1
oppnå	positive	1
oppnådd	positive	1
prestasjon	positive	1
stemme	positive	1
ansvarlighet	positive	1
ansvarlig	positive	1
akkreditert	positive	1
accueil	positive	1
nøyaktig	positive	1
forbannet	negative	1
beskyldning	negative	1
akkusativ	negative	1
anklaget	negative	1
anklager	negative	1
anklager	negative	1
ess	positive	1
vondt	negative	1
oppnå	positive	1
prestasjon	positive	1
vondt	negative	1
syre	negative	1
bekreftelse	positive	1
skaffe	positive	1
anskaffe	positive	1
akrobat	positive	1
handlings	positive	1
handlingsbar	negative	1
faktisk	positive	1
skarphet	positive	1
skarpsinnig	positive	1
tilpasse	positive	1
tilpasningsdyktig	positive	1
adder	negative	1
avhengighets	negative	1
adresserer	positive	1
dyktig	positive	1
tilstrekkelig	positive	1
fett	negative	1
bedømme	negative	1
tilleggs	positive	1
beundringsverdig	positive	1
admiral	positive	1
beundring	positive	1
beundre	positive	1
beundrer	positive	1
tillatt	positive	1
formaning	negative	1
søt	positive	1
tilbedelse	positive	1
elsker	positive	1
drift	negative	1
forfalsket	negative	1
utro	negative	1
gå	positive	1
avansert	positive	1
fremgang	positive	1
fordel	positive	1
fordelaktig	positive	1
advent	positive	1
eventyr	positive	1
eventyrlystne	positive	1
motstander	negative	1
motgang	negative	1
tilrådelig	positive	1
råd	positive	1
rådgiver	positive	1
advokat	positive	1
estetisk	positive	1
estetikk	positive	1
elskelig	positive	1
hengivenhet	positive	1
tilknyttet	positive	1
bekreft	positive	1
bekreftelse	positive	1
bekreftende	positive	1
bekreftende	positive	1
plaget	negative	1
plaget	negative	1
lidelse	negative	1
velstand	positive	1
velstående	positive	1
råd	positive	1
fornærmende	negative	1
redd	negative	1
på nytt	negative	0
etterspill	negative	1
ettersmak	negative	1
aga	positive	1
forverret	negative	1
skjerpende	negative	1
forverring	negative	1
aggresjon	negative	1
aggressiv	negative	1
angriper	negative	1
forferdelig	negative	1
smidig	positive	1
smidighet	positive	1
urolig	negative	1
uro	negative	1
plager	negative	1
smerte	negative	1
enig	positive	1
behagelig	positive	1
enige	positive	1
enig	positive	1
avtale	positive	1
landbruks	positive	1
fremover	positive	1
hjelp	positive	1
hjelpe	positive	1
dårlig	negative	1
skrantende	negative	1
formålsløs	negative	1
luftes	negative	1
alabast	positive	1
alarm	negative	1
alarmerende	negative	1
alkoholisme	negative	1
årvåkenhet	positive	1
fremmed	negative	1
fremmedgjøre	negative	1
fremmedgjort	negative	1
fremmedgjøring	negative	1
alimen	positive	1
underholdsbidrag	negative	1
levende	positive	1
avverge	positive	1
påstand	negative	1
hevder	negative	1
troskap	positive	1
allegro	positive	1
lindre	positive	1
lindring	positive	1
alliert	positive	1
tillatt	positive	1
lokke	positive	1
forlokkende	positive	1
alliert	positive	1
allmektig	positive	1
aloha	positive	1
reservert	negative	1
krangel	negative	1
utrolig	positive	1
ambassadør	positive	1
tvetydig	negative	1
ambisjon	positive	1
bakholds	negative	1
forbedre	positive	1
amen	positive	1
mottakelig	positive	1
endre	positive	1
endrer	positive	1
elskelig	positive	1
minnelig	positive	1
amnesi	negative	1
amnesti	positive	1
amour	positive	1
amfetamin	negative	1
underholde	positive	1
moret	positive	1
underholdnings	positive	1
morsomt	positive	1
anaconda	negative	1
anal	negative	1
analytiker	positive	1
anarkisme	negative	1
anarkistisk	negative	1
anarki	negative	1
anatem	negative	1
anker	positive	1
forankrings	positive	1
eldgamle	negative	1
engel	positive	1
engelsk	positive	1
sinne	negative	1
angina	negative	1
fiske	negative	1
sint	negative	1
kvalme	negative	1
animer	positive	1
animert	positive	1
fiendskap	negative	1
animus	negative	1
utslette	negative	1
utslettet	negative	1
utslettelse	negative	1
irritere	negative	1
irritasjons	negative	1
irriterende	negative	1
annullere	negative	1
annullering	negative	1
anomali	negative	1
anonym	negative	1
antagonisme	negative	1
antagonist	negative	1
antagonistisk	negative	1
miltbrann	negative	1
antibiotika	positive	1
antikrist	negative	1
motgift	positive	1
soppdrepende	positive	1
antipati	negative	1
forfalt	negative	1
antikke	positive	1
antiseptisk	positive	1
antisosialt	negative	1
antitese	negative	1
angst	negative	1
engstelig	negative	1
apache	negative	1
apatisk	negative	1
apati	negative	1
bladlus	negative	1
aplomb	positive	1
unnskyldende	positive	1
beklager	positive	1
unnskyldning	positive	1
apostel	positive	1
forferdelig	negative	1
blindtarmbetennelse	negative	1
applaus	positive	1
takknemlighet	positive	1
frykt	negative	1
bekymret	negative	1
godkjenning	positive	1
bevilgning	negative	1
godkjenning	positive	1
godkjenne	positive	1
godkjenner	positive	1
apt	positive	1
dyktighet	positive	1
arkeologisk	positive	1
arkaisk	negative	1
glødende	positive	1
glødende	positive	1
vanskelige	negative	1
argumentere	negative	1
argument	negative	1
argumenterende	negative	1
tørr	negative	1
aristokrati	positive	1
aristokratisk	positive	1
opprustning	negative	1
væpnet	negative	1
bevæpnet	positive	1
rustning	positive	1
aroma	positive	1
vekke	positive	1
arraignment	negative	1
rekke	positive	1
restanse	negative	1
arrestere	negative	1
arroganse	negative	1
arrogant	negative	1
arse	negative	1
brannstiftelse	negative	1
kunst	positive	1
artikuler	positive	1
artikulasjon	positive	1
artilleri	negative	1
håndverks	positive	1
kunstnerisk	positive	1
kunstnerisk	positive	1
stigning	positive	1
stigning	positive	1
aske	negative	1
skamfull	negative	1
skammet seg	positive	0
aske	negative	1
ambisjon	positive	1
håpe	positive	1
håper	positive	1
ass	negative	1
angrip	negative	1
angriper	negative	1
snikmorder	negative	1
myrde	negative	1
attentat	negative	1
overgreps	negative	1
monterings	positive	1
samtykke	positive	1
hevder	positive	1
eiendeler	positive	1
drittsekk	negative	1
assister	positive	1
assistanse	positive	1
assosier	positive	1
assuage	positive	1
forsikring	positive	1
forsikret	positive	1
utrolig	positive	1
overraskelse	positive	1
avvike	negative	1
snerpende	negative	1
astrolog	positive	1
astronaut	positive	1
astronom	positive	1
skarpt	positive	1
asyl	negative	1
ateisme	negative	1
aterosklerose	negative	1
atlet	positive	1
atletisk	positive	1
atom	positive	1
sone	positive	1
forsoning	positive	1
fryktelig	negative	1
grusomhet	negative	1
atrofi	negative	1
vedlegg	positive	1
angrip	negative	1
angripende	negative	1
oppnåelig	positive	1
ledsager	positive	1
oppmerksomhets	positive	1
oppmerksom	positive	1
svekket	negative	1
demping	negative	1
vitner	positive	1
advokat	positive	1
tiltreknings	positive	1
attraktivitet	positive	1
dristighet	negative	1
august	positive	1
tante	positive	1
aura	positive	1
lykkebringende	positive	1
streng	negative	1
innstrammings	negative	1
autentisk	positive	1
ekthet	positive	1
forfatter	positive	1
autoritativ	positive	1
autoritets	positive	1
autorisasjons	positive	1
godkjent	positive	1
autokratisk	negative	1
obduksjon	negative	1
skred	negative	1
gjernings	negative	1
avatar	positive	1
hevner	negative	1
aversjon	negative	1
unngå	negative	1
unngåelse	negative	1
tildel	positive	1
forferdelig	negative	1
klosset	negative	1
galt	negative	1
ay	positive	1
aye	positive	1
babble	negative	1
babling	negative	1
bavian	negative	1
baby	positive	1
baccalaureat	positive	1
ryggrads	positive	1
bakover	negative	1
bakover	negative	1
bakvann	negative	1
bakterie	negative	1
bakterie	negative	1
dårlig	negative	1
grevling	negative	1
dårlig	negative	1
dårlig	negative	1
namsmann	negative	1
agn	negative	1
balansere	positive	1
balansert	positive	1
balle	negative	1
balk	negative	1
ballade	positive	1
ballett	positive	1
stemmeseddel	positive	1
balsam	negative	1
balsam	positive	1
balsam	positive	1
forbud	negative	1
banditt	negative	1
bane	negative	1
bang	negative	1
banger	negative	1
forvis	negative	1
forvist	negative	1
forvisning	negative	1
konkurs	negative	1
konkurs	negative	1
bankett	positive	1
banshee	negative	1
dåps	positive	1
dåps	positive	1
barb	negative	1
barbar	negative	1
barbarisk	negative	1
barbarisme	negative	1
bard	positive	1
prute	positive	1
bjeff	negative	1
sperret	negative	1
ufruktbar	negative	1
barrikade	negative	1
barriere	negative	1
grunnløs	negative	1
basketball	positive	1
bastard	negative	1
bastion	positive	1
bad	positive	1
batter	negative	1
voldsom	negative	1
batteri	negative	1
kamp	negative	1
kjempet	negative	1
slagmark	negative	1
bawdy	negative	1
bajonett	negative	1
stråle	positive	1
strålende	positive	1
bærer	negative	1
dyret	negative	1
beastly	negative	1
slå	negative	1
forskjønnelse	positive	1
vakker	positive	1
forskjønne	positive	1
skjønnhets	positive	1
grunnfjells	positive	1
øl	positive	1
treffer	negative	1
venner	positive	1
beg	negative	1
tigger	negative	1
tigger	negative	1
behemoth	negative	1
se	negative	1
forsinket	negative	1
tro	positive	1
nedsett	negative	1
krigførende	negative	1
belte	negative	1
bender	negative	1
velgjører	positive	1
gunstig	positive	1
fordel	positive	1
velvillig	positive	1
godartet	positive	1
bedøvet	negative	1
sorg	negative	1
berøvet	negative	1
berserk	negative	1
køye	positive	1
bestial	negative	1
forråde	negative	1
svik	negative	1
forlovet	positive	1
forbedrings	positive	1
drikke	positive	1
forsiktig	negative	1
forvirret	negative	1
bias	negative	1
partisk	negative	1
bibelsk	positive	1
kranglete	negative	1
bier	negative	1
kriminell	negative	1
stort	negative	1
galle	negative	1
tospråklig	positive	1
biopsi	negative	1
bjørke	negative	1
fødsels	positive	1
bursdags	positive	1
fødested	negative	1
tispe	negative	1
bite	negative	1
bittert	negative	1
bitterhet	negative	1
bisarr	negative	1
svart	negative	1
blackjack	negative	1
utpressing	negative	1
svarthet	negative	1
skyld	negative	1
feilfri	positive	1
kjedelig	negative	1
blasfemisk	negative	1
blasfemi	negative	1
eksplosjons	negative	1
åpenbar	negative	1
blader	negative	1
flamme	negative	1
dyster	negative	1
blødnings	negative	1
feil	negative	1
velsign	positive	1
velsignet	positive	1
velsignende	positive	1
rødhet	negative	1
ødelagt	negative	1
blind	negative	1
blindet	negative	1
blindt	negative	1
blindhet	negative	1
lykke	positive	1
lykksalig	positive	1
blister	negative	1
oppblåst	negative	1
blob	negative	1
blokkade	negative	1
blodløs	positive	1
blodsutgytelse	negative	1
blodtørstig	negative	1
blodig	negative	1
blomstre	positive	1
blomstre	positive	1
blott	negative	1
blåser	negative	1
utblåsning	negative	1
blues	negative	1
bløff	negative	1
feil	negative	1
uskarphet	negative	1
uskarpt	negative	1
rødme	negative	1
skryte	negative	1
skryte	positive	1
med	negative	1
livvakt	positive	1
myre	negative	1
falske	negative	1
kok	negative	1
kokeplate	negative	1
boisterous	negative	1
voldsomt	positive	1
fet	positive	1
dristighet	positive	1
styrke	positive	1
bombe	negative	1
bombardere	negative	1
bombardement	negative	1
bombet	negative	1
bonanza	positive	1
trelldom	negative	1
obligasjoner	negative	1
bonne	positive	1
bonus	positive	1
boo	negative	1
booby	negative	1
bookish	positive	1
bokhandel	positive	1
bokorm	negative	1
bokorm	positive	1
velsignelse	positive	1
sprit	negative	1
bar	negative	1
kjedsomhet	negative	1
kjedelig	negative	1
låner	negative	1
plage	negative	1
plager	negative	1
bunn	negative	1
bundet	negative	1
rikelig	positive	1
gavmildt	positive	1
bukett	positive	1
bout	negative	1
storfe	negative	1
gutt	negative	1
boikott	negative	1
skryte	negative	1
hjerner	positive	1
brandy	negative	1
bravado	negative	1
modig	positive	1
slagsmål	negative	1
brazen	negative	1
brudd	negative	1
sammenbrudd	negative	1
frokost	positive	1
rasende	negative	1
brudd	negative	1
bestikkelses	negative	1
bestikkelses	negative	1
brude	positive	1
brude	positive	1
brudgom	positive	1
brudepike	positive	1
brigade	negative	1
lyse	positive	1
lysstyrke	positive	1
strålende	positive	1
svovel	negative	1
bust	negative	1
bredde	negative	1
brokade	positive	1
broil	negative	1
brøt	negative	1
ødelagt	negative	1
bordell	negative	1
bror	positive	1
broderskap	positive	1
broderlig	positive	1
blåmerker	negative	1
brunt	negative	1
brutal	negative	1
brutalitet	negative	1
brutalt	negative	1
bukk	negative	1
bukk	positive	1
kompis	positive	1
buffé	negative	1
buffé	positive	0
feil	negative	1
bugaboo	negative	1
bygge	positive	1
bygge	positive	1
pære	negative	1
bulldog	positive	1
skuddsikker	positive	1
mobbe	negative	1
bum	negative	1
bummer	negative	1
bøye	positive	1
belastende	negative	1
byråkrati	negative	1
byråkrat	negative	1
innbruddstyv	negative	1
innbrudd	negative	1
begravelses	negative	1
begravet	negative	1
burke	negative	1
brent	negative	1
buss	positive	1
busted	negative	1
slakter	negative	1
butler	positive	1
rumpe	negative	1
buttery	positive	1
buxom	positive	1
buzz	positive	1
surret	negative	1
førerhus	positive	1
kabal	negative	1
skap	positive	1
kakofoni	negative	1
cad	negative	1
kadaver	negative	1
kafé	negative	0
kafé	positive	1
bur	negative	1
beregne	negative	1
kalkulator	positive	1
kalv	positive	1
ufølsom	negative	1
kaller	negative	1
rolig	positive	1
kampanje	negative	1
kanari	positive	1
avbryt	negative	1
kreft	negative	1
oppriktig	positive	1
kandidat	positive	1
kandisert	positive	1
kanker	negative	1
kannibal	negative	1
kannibalisme	negative	1
kanon	negative	1
kapitalistisk	positive	1
kaptein	positive	1
fengende	positive	1
fengende	positive	1
fanget	negative	1
fangenskap	negative	1
capitor	negative	1
fange	negative	1
kadaver	negative	1
karsinom	negative	1
kardiomyopati	negative	1
karriere	positive	1
forsiktig	positive	1
nøye	positive	1
uforsiktighet	negative	1
kjærtegn	positive	1
vaktmester	positive	1
karikatur	negative	1
karies	negative	1
blodbad	negative	1
kjødelig	negative	1
kjøttetende	negative	1
carol	positive	1
kartell	negative	1
kaskade	positive	1
saks	negative	1
kontant	positive	1
skrin	negative	1
kast	negative	1
ulykkes	negative	1
grå stær	negative	1
katastrofe	negative	1
kategorisk	positive	1
imøtekomme	positive	1
katartisk	positive	1
katedral	positive	1
kateter	negative	1
forsiktig	negative	1
forsiktig	positive	1
forsiktig	positive	1
avstå	negative	1
feiret	positive	1
feirer	positive	1
feiring	positive	1
kjendis	negative	1
kjendis	positive	1
himmelsk	positive	1
kirkegård	negative	1
sensur	negative	1
sensur	negative	1
senter	positive	1
centurion	positive	1
cerebral	positive	1
seremoni	positive	1
sikkerhet	positive	1
stopp	negative	1
opphør	negative	1
ag	negative	1
gnager	negative	1
ubehagelig	negative	1
styreleder	positive	1
styreleder	positive	1
utfordre	negative	1
mester	positive	1
chant	positive	1
kaos	negative	1
kaotisk	negative	1
charade	negative	1
belastbar	negative	1
lader	positive	1
veldedig	positive	1
veldedighet	positive	1
sjarm	positive	1
sjarmert	negative	1
sjarmert	positive	1
sjarmerende	positive	1
jage	negative	1
tukt	negative	1
kyskhets	positive	1
chattering	positive	1
chatty	negative	1
billig	negative	1
juks	negative	1
sjekkliste	positive	1
heie	positive	1
munter	positive	1
munterhet	positive	1
heier	positive	1
koselig	positive	1
ostekake	negative	1
kjemiker	positive	1
verne	positive	1
kirsebær	positive	1
chicane	negative	1
høvding	positive	1
barn	positive	1
barndoms	positive	1
barnslig	negative	1
kjølig	negative	1
kvitre	positive	1
meisel	positive	1
ridderlighet	positive	1
kloroform	negative	1
sjokolade	positive	1
valg	positive	1
kor	positive	1
choke	negative	1
kolera	negative	1
hakk	negative	1
kor	positive	1
chore	negative	1
kor	positive	1
valgt	positive	1
chowder	positive	1
kronisk	negative	1
kronikk	positive	1
humrer	positive	1
kirke	positive	1
cider	positive	1
sigarett	negative	1
omgåelse	negative	1
omgåelses	positive	1
innbygger	positive	1
sivilt	positive	1
høflighets	positive	1
sivilisasjon	positive	1
siviliserte	positive	1
klarsynt	positive	1
klamring	negative	1
klapp	positive	1
avklare	positive	1
sammenstøt	negative	1
sammenstøtende	negative	1
klassisk	positive	1
klassisk	positive	1
klassikere	positive	1
klassifiser	positive	1
klassekamerat	positive	1
klo	negative	1
ren	positive	1
rengjørings	positive	1
renslighet	positive	1
rent	positive	1
rens	positive	1
rensende	positive	1
klaring	positive	1
klarhet	positive	1
geistlig	positive	1
smart	positive	1
kløktig	positive	1
klimaks	positive	1
kloster	negative	1
nærhet	positive	1
lukking	positive	1
kle	positive	1
overskyet	negative	1
uklarhet	negative	1
klovn	positive	1
klump	negative	1
klønete	negative	1
koalisjon	positive	1
kyst	positive	1
kokain	negative	1
tving	negative	1
tvangs	negative	1
sameksistere	positive	1
kiste	negative	1
kogent	positive	1
kognitiv	positive	1
sammenheng	positive	1
sammenhengende	positive	1
sammenhengende	positive	1
kaldt	negative	1
kaldt	negative	1
kulde	negative	1
kolikk	negative	1
kollaps	negative	1
samlet	positive	1
kollisjon	negative	1
kollusjons	negative	1
oberst	positive	1
kolossalt	positive	1
koma	negative	1
komatøs	negative	1
bekjemp	negative	1
stridende	negative	1
bekjempende	negative	1
komfort	positive	1
kommandant	positive	1
kommanderende	positive	1
minnes	positive	1
minne	positive	1
minne	positive	1
ros	positive	1
prisverdig	positive	1
kommentator	positive	1
forpliktende	negative	1
forpliktet	positive	1
commodore	positive	1
samfunns	positive	1
oppstyr	negative	1
kommunisere	positive	1
kommunikativ	positive	1
nattverd	positive	1
kommunismens	negative	1
kommunistisk	negative	1
fellesskaps	positive	1
kommutasjon	positive	1
pendle	positive	1
følgesvenn	positive	1
medfølelse	positive	1
medfølende	positive	1
kompatibilitet	positive	1
kompatibel	positive	1
overbevisende	positive	1
kompensere	positive	1
kompenserende	positive	1
kompetanse	positive	1
kompetanse	positive	1
kompetent	positive	1
konkurranse	negative	1
tilfredshet	positive	1
klage	negative	1
klage	negative	1
utfylle	positive	1
utfyllende	positive	1
helt	positive	1
fullstendighet	positive	1
fullføre	positive	1
gjennomføring	positive	1
sammensatt	negative	1
kompleksitet	negative	1
kompatibel	positive	1
komplisere	negative	1
komplisert	negative	1
komplikasjon	negative	1
medvirkning	negative	1
medvirkende	positive	1
kompliment	positive	1
sammensatt	positive	1
komponist	positive	1
kompost	negative	1
forstå	positive	1
omfattende	positive	1
tvangs	negative	1
obligatorisk	negative	1
kamerat	positive	1
skjul	negative	1
skjult	negative	1
skjul	negative	1
innbilsk	negative	1
innbilsk	negative	1
konsentrisk	positive	1
forlik	positive	1
avsluttende	positive	1
samsvar	positive	1
samstemmende	positive	1
hjernerystelse	negative	1
fordømme	negative	1
fordømmelse	negative	1
nedlatende	negative	1
nedlatende	negative	1
kondolanse	positive	1
godta	positive	1
bidrar	positive	1
ledningsevne	positive	1
konfødererte	positive	1
innrømme	negative	1
tilstå	positive	1
bekjennelse	negative	1
tillits	positive	1
trygg	positive	1
begrense	negative	1
begrenset	negative	1
inneslutning	negative	1
bekreftet	positive	1
konfiskere	negative	1
inndragning	negative	1
brann	negative	1
konflikt	negative	1
motstridende	negative	1
konformitet	positive	1
forvirre	negative	1
forvirret	negative	1
forvirre	negative	1
forvirring	negative	1
medfødt	positive	1
overbelastning	negative	1
gratulerer	positive	1
menighets	positive	1
kongruens	positive	1
fremkaller	negative	1
kjenner	positive	1
erobrings	negative	1
samvittighets	positive	1
samvittighetsfull	positive	1
bevissthets	positive	1
innvielses	positive	1
bevarings	positive	1
bevare	positive	1
betydelig	positive	1
hensynsfull	positive	1
konsistens	positive	1
konsoll	positive	1
konsonant	positive	1
konspirator	negative	1
konspirere	negative	1
konstant	positive	1
konstant	positive	1
forferdelse	negative	1
forstoppelse	negative	1
konstitusjonell	positive	1
begrense	negative	1
begrenset	negative	1
begrensning	negative	1
konstruer	positive	1
fullstendig	positive	1
kontakt	positive	1
smitte	negative	1
smittsom	negative	1
forurense	negative	1
forurenset	negative	1
forurensning	negative	1
kontemplasjon	positive	1
forakt	negative	1
foraktelig	negative	1
foraktende	negative	1
innholds	positive	1
omstridt	negative	1
fortsett	positive	1
kontur	positive	1
smugling	negative	1
kontrakt	negative	1
motsier	negative	1
motsetning	negative	1
motstridende	negative	1
motsatt	negative	1
kontrast	negative	1
bryter	negative	1
kontravensjons	negative	1
bidra	positive	1
bidragsyter	positive	1
kontroversiell	negative	1
kontrovers	negative	1
praktisk	positive	1
praktisk	positive	1
kloster	positive	1
konvensjon	positive	1
samtale	positive	1
samtale	positive	1
konverter	positive	1
dømme	negative	1
overbevisning	negative	1
overbevise	positive	1
kult	positive	1
kjølig	positive	1
coop	negative	1
samarbeide	positive	1
samarbeider	positive	1
samarbeid	positive	1
samarbeids	positive	1
kopier	negative	1
kopier	negative	1
kjerne	positive	1
kroning	positive	1
korrigerings	negative	1
korporal	negative	1
bedriftens	positive	1
kroppslig	positive	1
lik	negative	1
korreksjons	negative	1
korrigerende	positive	1
korrespondanse	positive	1
bekrefte	positive	1
korrosjons	negative	1
etsende	negative	1
korrupt	negative	1
ødeleggende	negative	1
korrupsjon	negative	1
kosmopolitisk	positive	1
koselig	positive	1
hoste	negative	1
råds	positive	1
råd	positive	1
rådgiver	negative	1
rådgiver	positive	1
telle	positive	1
grevinne	positive	1
mot	positive	1
modig	positive	1
kursing	negative	1
høflige	positive	1
høflighet	positive	1
frieri	positive	1
vik	positive	1
pakt	positive	1
begjærlig	negative	1
feig	negative	1
feighet	negative	1
feigt	negative	1
crabby	negative	1
sprekk	negative	1
sprukket	negative	1
sprekker	negative	1
vugge	positive	1
håndverks	positive	1
håndverker	positive	1
kramp	negative	1
trangt	negative	1
sveiv	negative	1
cranky	negative	1
dritt	negative	1
krasj	negative	1
krype	negative	1
gal	negative	1
gal	negative	1
knirkende	negative	1
krem	positive	1
skape	positive	1
kreativ	positive	1
skapning	negative	1
troverdighet	positive	1
legitimasjon	positive	1
troverdighet	positive	1
troverdig	positive	1
kreditt	positive	1
kredittverdige	positive	1
kreditert	positive	1
krype	negative	1
crescendo	positive	1
kriminell	negative	1
kriminelt	negative	1
kriminalitet	negative	1
krympe	negative	1
lammet	negative	1
lammet	negative	1
krisens	negative	1
skarp	negative	1
kritiker	negative	1
kritikk	negative	1
kritisere	negative	1
kritisk	positive	1
skurk	negative	1
kryss	negative	1
hukende	negative	1
krone	positive	1
avgjørende	positive	1
kors	negative	1
korsfestelse	negative	1
rå	negative	1
grusom	negative	1
grusomt	negative	1
grusomhet	negative	1
smuldrer	negative	1
knase	negative	1
korstog	negative	1
knust	negative	1
knusing	negative	1
crusty	negative	1
gråte	negative	1
gråter	negative	1
krypte	negative	1
krystall	positive	1
hanrei	negative	1
gjøk	negative	1
kose	positive	1
kulinarisk	positive	1
utslett	negative	1
kulminasjon	positive	1
skyld	negative	1
skyldig	negative	1
skyldig	negative	1
kult	negative	1
kultiver	positive	1
dyrket	positive	1
dyrking	positive	1
kultur	positive	1
tungvint	negative	1
listig	negative	1
listig	positive	1
cupping	negative	1
cur	negative	1
herdbar	positive	1
nysgjerrighet	positive	1
krøll	positive	1
forbannelse	negative	1
forbannet	negative	1
forbannelse	negative	1
kortvarig	negative	1
pute	positive	1
kunde	positive	1
søt	positive	1
kutter	negative	1
skjære	negative	1
cyanid	negative	1
syklon	negative	1
cyste	negative	1
cytomegalovirus	negative	1
dabbling	negative	1
daemon	negative	1
dumt	negative	1
dolk	negative	1
skade	negative	1
skader	negative	1
dame	positive	1
jævla	negative	1
forbannelse	negative	1
forbannet	negative	1
spjeld	negative	1
dans	positive	1
flass	negative	1
dandy	negative	1
fare	negative	1
farlig	negative	1
dristig	positive	1
mørkere	negative	1
mørkt	negative	1
mørke	negative	1
kjære	positive	1
stiplet	negative	1
imponerende	positive	1
ulastelig	negative	1
datter	positive	1
daggry	positive	1
bedøvet	negative	1
deaktiver	negative	1
fastlåst	negative	1
dødelig	negative	1
døv	negative	1
avtale	positive	1
kjære	positive	1
døds	negative	1
debacle	negative	1
debatt	positive	1
utroskap	negative	1
rusk	negative	1
gjeld	negative	1
skyldner	negative	1
forfall	negative	1
forfalt	negative	1
avdøde	negative	1
bedrag	negative	1
villedende	negative	1
lure	negative	1
lurt	negative	1
lure	negative	1
anstendighet	positive	1
grei	positive	1
bedrag	negative	1
villedende	negative	1
erklærende	positive	1
avvisning	negative	1
nedgang	negative	1
synkende	negative	1
nedbrytning	negative	1
redusere	negative	1
nedgang	negative	1
forfalt	negative	1
decry	negative	1
dedikasjon	positive	1
trekke	negative	1
ærekrenkelse	negative	1
ærekrenkende	negative	1
standard	negative	1
nederlag	negative	1
beseiret	negative	1
feil	negative	1
avhending	negative	1
defekt	negative	1
forsvare	positive	1
forsvarte	positive	1
forsvarer	positive	1
forsvare	positive	1
forsvar	positive	1
forsvarsløs	negative	1
utsettelse	negative	1
trass	negative	1
trassig	negative	1
mangel	negative	1
underskudd	negative	1
definitivt	positive	1
tøm	negative	1
deflasjon	negative	1
deformere	negative	1
deformert	negative	1
deformitet	negative	1
svindle	negative	1
nedlagte	negative	1
trosser	negative	1
utartet	negative	1
nedbrytning	negative	1
nedbryt	negative	1
nedverdigende	negative	1
grad	positive	1
forsinkelse	negative	1
forsinket	negative	1
herlig	positive	1
delegat	positive	1
skadelig	negative	1
sletting	negative	1
bevisst	positive	1
deilig	positive	1
glede	positive	1
glade	positive	1
herlig	positive	1
kriminell	negative	1
misligholdt	negative	1
vanvittig	negative	1
delirium	negative	1
utfrielse	positive	1
levering	positive	1
vannflod	negative	1
illusjon	negative	1
vrangforestillings	negative	1
etterspørsel	negative	1
krevende	negative	1
dement	negative	1
demens	negative	1
død	negative	1
demokrati	positive	1
rive	negative	1
riving	negative	1
demon	negative	1
demonisk	negative	1
påviselig	positive	1
demonstrativt	positive	1
demoralisert	negative	1
benektelse	negative	1
nektet	negative	1
fordømme	negative	1
oppsigelse	negative	1
benekt	negative	1
benekter	negative	1
avgang	negative	1
avgang	negative	1
avhengighets	negative	1
avhengighets	negative	1
avhengig	negative	1
avhengig	positive	1
beklagelig	negative	1
beklager	negative	1
deporter	negative	1
utvisning	negative	1
fordervet	negative	1
ødeleggelses	negative	1
avskrive	negative	1
avskrevet	negative	1
avskrivninger	negative	1
trykk	negative	1
deprimert	negative	1
deprimerende	negative	1
depresjon	negative	1
depressivt	negative	1
deprivasjon	negative	1
dybde	positive	1
forvirret	negative	1
forsømt	negative	1
latterliggjøring	negative	1
unntak	negative	1
nedsettende	negative	1
beskrivende	positive	1
vanhellig	negative	1
ørken	negative	1
øde	negative	1
desertering	negative	1
fortjener	positive	1
fortjent	positive	1
designer	positive	1
ønskelig	positive	1
ønsker	positive	1
ønskelig	positive	1
avstå	negative	1
øde	negative	1
fortvilelse	negative	1
fortvilet	negative	1
desperat	negative	1
foraktelig	negative	1
forakte	negative	1
despotisk	negative	1
despotisme	negative	1
destinasjons	positive	1
fattig	negative	1
ødelagt	negative	1
ødelegger	negative	1
ødelegge	negative	1
ødeleggelse	negative	1
destruktivt	negative	1
løsrivelse	negative	1
holde tilbake	negative	1
internert	negative	1
oppdage	positive	1
frihetsberøvelse	negative	1
forverres	negative	1
forverret	negative	1
forverring	negative	1
bestemt	positive	1
avskyr	negative	1
detonere	negative	1
forringe	negative	1
skadelig	negative	1
ødelegge	negative	1
ødeleggende	negative	1
ødeleggelse	negative	1
utvikle seg	positive	1
djevel	negative	1
djevelsk	negative	1
lure	negative	1
devolusjons	negative	1
andaktig	positive	1
sluke	negative	1
hengiven	positive	1
fingerferdighet	positive	1
djevelsk	negative	1
diagnose	negative	1
diamant	positive	1
dagbok	positive	1
diatribe	negative	1
diktator	negative	1
diktatorisk	negative	1
diktatur	negative	1
ordbok	positive	1
didaktisk	positive	1
dø	negative	1
diett	positive	1
vanskeligheter	negative	1
vanskelighets	negative	1
verdig	positive	1
verdighet	positive	1
gå ut	negative	1
falleferdig	negative	1
flid	positive	1
fortynn	negative	1
redusere	negative	1
redusert	negative	1
din	negative	1
middag	positive	1
diplomati	positive	1
diplomatisk	positive	1
alvorlig	negative	1
direktør	positive	1
smuss	negative	1
skitten	negative	1
uførhet	negative	1
deaktiver	negative	1
deaktivert	negative	1
misfornøyd	negative	1
uenig	negative	1
uenig	negative	1
uenighet	negative	1
ikke tillatt	negative	1
skuffe	negative	1
skuffet	negative	1
skuffende	negative	1
skuffelse	negative	1
avvisning	negative	1
ikke godkjenne	negative	1
ikke godkjent	negative	1
misbilligende	negative	1
katastrofe	negative	1
katastrofalt	negative	1
ikke tro	negative	1
kaster	negative	1
utslipp	negative	1
disiplin	negative	1
fraskriver deg	negative	1
misfarging	negative	1
misfarget	negative	1
ubehag	negative	1
koble fra	negative	1
frakoblet	negative	1
frakobling	negative	1
misnøye	negative	1
avviklingsposisjon 0
avvikle	negative	1
diskontinuitets	negative	1
uenighet	negative	1
motvirke	negative	1
motløshet	negative	1
oppdagelses	positive	1
diskreditere	negative	1
diskret	positive	1
skjønn	positive	1
skjønnsmessig	positive	1
diskriminerende	negative	1
diskriminerende	negative	1
diskriminering	negative	1
forakt	negative	1
sykdoms	negative	1
syk	negative	1
kroppsløs	negative	1
frakobling	negative	1
vansatt	negative	1
skam	negative	1
vanæret	negative	1
skammelig	negative	1
misfornøyd	negative	1
avsky	negative	1
ekkelt	negative	1
motløs	negative	1
nedslående	negative	1
uærlig	negative	1
uærlighet	negative	1
vanære	negative	1
desillusjon	negative	1
desinfeksjons	positive	1
desinformasjon	negative	1
ubehagelig	negative	1
disintegrere	negative	1
oppløsnings	negative	1
uinteressert	negative	1
misliker	negative	1
mislikte	negative	1
dislokert	negative	1
trist	negative	1
forferdelse	negative	1
splittelse	negative	1
oppsigelse	negative	1
ulydighet	negative	1
ulydig	negative	1
ulydige	negative	1
lidelse	negative	1
uregelmessig	negative	1
uorganisert	negative	1
nedsettende	negative	1
nedsettende	negative	1
ulikhet	negative	1
lidenskapelig	negative	1
fjerne	negative	1
dispersjons	negative	1
forskyve	negative	1
misfornøyd	negative	1
misnøye	negative	1
avhending	negative	1
disponert	positive	1
fratatt	negative	1
tvist	negative	1
diskvalifisering	negative	1
diskvalifisert	negative	1
diskvalifisere	negative	1
se bort fra	negative	1
ignorert	negative	1
uærlig	negative	1
respektløs	negative	1
respektløs	negative	1
forstyrrelse	negative	1
misnøye	negative	1
spre	positive	1
dissens	negative	1
dissens	negative	1
dårlig service	negative	1
dissident	negative	1
oppløsnings	negative	1
dissonans	negative	1
avsmak	negative	1
usmakelig	negative	1
destillasjon	positive	1
skillet	positive	1
forvrengt	negative	1
forvrengning	negative	1
distrahere	negative	1
distrahert	negative	1
distraherende	negative	1
distraksjon	negative	1
forvirret	negative	1
nød	negative	1
ubehagelig	negative	1
bekymringsfullt	negative	1
mistillit	negative	1
forstyrrelse	negative	1
forstyrret	negative	1
bruk	negative	1
nedlagt	negative	1
ditty	positive	1
divergerende	negative	1
mangfoldig	negative	1
mangfoldig	positive	1
diversifisert	positive	1
avledning	positive	1
solgt	negative	1
frasalg	negative	1
guddommelig	positive	1
skilsmisse	negative	1
svimmelhet	negative	1
svimmel	negative	1
forankret	negative	1
lege	positive	1
gjernings	positive	1
dogged	positive	1
doit	negative	1
tretthet	negative	1
dole	negative	1
dolor	negative	1
delfin	positive	1
dominerende	negative	1
dominere	negative	1
dominere	positive	1
dominans	negative	1
ikke	positive	1
esel	negative	1
doodle	negative	1
undergang	negative	1
dømt	negative	1
dommedags	negative	1
tvil	negative	1
tvilsom	negative	1
tviler	negative	1
utvilsomt	positive	1
dusj	negative	1
dour	negative	1
due	positive	1
fall	negative	1
regnskyll 0
rett og slett	positive	ive 0
dunete	positive	1
medgift positiv
trist	negative	1
drenerings	negative	1
ulempe	negative	1
frykt	negative	1
forferdelig	negative	1
fryktelig	negative	1
kjedelig	negative	1
drikker	negative	1
driv	negative	1
drone	negative	1
hengende	negative	1
tørke	negative	1
drukner	negative	1
døsighet	negative	1
slitasje	negative	1
beruset	negative	1
fyllesyke	negative	1
tvilsom	negative	1
på grunn	negative	0
duett	positive	1
hertug	positive	1
kjedelig	negative	1
dumt	negative	1
dummy	negative	1
dumper	negative	1
dun	negative	1
fangehull	negative	1
lure	negative	1
duplisitet	negative	1
dobbelhet 0
holdbarhet	positive	1
holdbar	positive	1
tvangs	negative	1
støv	negative	1
pliktoppfyllende	positive	1
dverg	negative	1
døende	negative	1
dysenteri	negative	1
ivrig	positive	1
iver	positive	1
jarl	positive	1
tjen	positive	1
alvorlig	positive	1
oppriktig	positive	1
alvorlig	positive	1
jordskjelv	negative	1
lette	positive	1
servitutt	positive	1
lettvint	positive	1
spis	positive	1
avlytting	negative	1
ecstasy-	positive	1
ekstatisk	positive	1
edikt	negative	1
oppbyggelse	positive	1
utdanne	positive	1
utdannet	positive	1
pedagogisk	positive	1
effektiv	positive	1
effeminate	negative	1
effekt	positive	1
effektivitets	positive	1
effektiv	positive	1
innsats	positive	1
egoistisk	negative	1
alvorlig	negative	1
utløsning	positive	1
kast ut	negative	1
kast ut	positive	0
utkast	negative	1
utdypning	positive	1
glade	positive	1
eldre	positive	1
eldste	positive	1
velg	positive	1
elektrisk	positive	1
strøm	positive	1
eleganse	positive	1
elegant	positive	1
høyde	positive	1
kvalifisert	positive	1
eliminering	negative	1
elite	positive	1
ellips er	positive	0
veltalenhet	positive	1
veltalende	positive	1
belyse	positive	1
unnvikende	negative	1
avmagret	negative	1
frigjøring	positive	1
embargo	negative	1
gå ut	negative	0
gå ut	positive	0
flau	negative	1
pinlig	negative	1
forlegenhet	negative	1
legge inn	negative	0
legge inn	positive	0
underslag	negative	1
emboli	negative	1
omfavne	positive	1
brokket	negative	1
dukker opp	negative	0
dukker opp	positive	0
nødsituasjon	negative	1
emeritus	positive	1
eminens	positive	1
fremtredende	positive	1
ypperlig	positive	1
emir	positive	1
empati	positive	1
gi	positive	1
etterlign	positive	1
aktivere	positive	1
aktivering	positive	1
fortryllende	positive	1
fortryllet	positive	1
fortryllende	positive	1
enklave	negative	1
legg til	negative	0
legg til	positive	0
encore	positive	1
oppmuntre	positive	1
oppmuntring	positive	1
inngrep	negative	1
heftelses	negative	1
leksikon	positive	1
fare	negative	1
truet	negative	1
streve	positive	1
endemisk	negative	1
uendelig	negative	1
uendelig	positive	1
gi	positive	1
utstyrt	positive	1
begavelse	positive	1
utholdenhets	positive	1
tåle	positive	1
fiendens	negative	1
energisk	positive	1
håndheve	negative	1
håndheve	positive	1
håndhevelse	negative	1
engasjert	positive	1
engasjerende	positive	1
forbedre	positive	1
gåtefull	negative	1
nyt	positive	1
nyter	positive	1
opplyst	positive	1
opplysnings	positive	1
livne opp	negative	0
livne opp	positive	1
fiendskap	negative	1
berike	positive	1
registrer deg	positive	0
ensemble	positive	1
banner	positive	1
slave	negative	1
slaver	negative	1
slaveri	negative	1
viklet	negative	1
vikling	negative	1
skriv inn	negative	0
skriv inn	positive	0
initiativrik	positive	1
underholde	positive	1
underholdt	positive	1
underholdende	positive	1
entusiasme	positive	1
entusiast	positive	1
innvoller	negative	1
gründer	negative	0
gründer	positive	0
misunnelig	negative	1
miljø	positive	1
forestille seg	negative	0
flyktning er	positive	1
episk	positive	1
epidemisk	negative	1
epilepsi	negative	1
epitet positiv
epitome	positive	1
likestillings	positive	1
like	positive	1
likevekt	positive	1
egenkapital	positive	1
utrydde	negative	1
utryddelse	negative	1
slett	negative	1
erosjon	negative	1
erotisk	negative	1
erotisk	positive	1
feil	negative	1
ærend	positive	1
feilaktige	negative	1
uberegnelig	negative	1
erratum	negative	1
feil	negative	1
feil	negative	1
eruditt	positive	1
utbrudd	negative	1
bryte ut	positive	0
utbrudd	negative	1
eskalere	negative	1
unnslippe	negative	1
unnslippe	positive	1
unngå	negative	1
spionasje	negative	1
tilslutte seg	negative	0
esprit	positive	1
essens	positive	e 0
essensielt	positive	1
i det vesentlige	negative	0
i det vesentlige	positive	0
etablert	positive	1
respekt	positive	1
estetisk	positive	1
fremmede	negative	1
etisk	positive	1
etikk	positive	1
dødshjelp	negative	1
evakuer	negative	1
evakuering	negative	1
unngå	negative	1
unnvikelse	negative	1
eviggrønne	positive	1
evig	positive	1
kaste ut	negative	1
kaste ut	positive	0
utkastelse	negative	1
tydelig	positive	1
ond	negative	1
evolusjons	positive	1
utvikle seg	negative	0
utvikle seg	positive	0
forverre	negative	1
forverring	negative	1
krevende	negative	1
overdriv	negative	1
overdrevet	negative	1
opphøye	positive	1
opphøyelse	positive	1
opphøyet	positive	1
undersøkelse	negative	1
irritasjon	negative	1
grav ut	negative	0
utgraving	negative	1
overstige	positive	1
utmerke seg	negative	0
utmerke seg	positive	1
fremragende kvalitet 1
utmerket	positive	1
overskytende	negative	1
for mye	positive	0
bytt	positive	1
avgifts	negative	1
spennende	positive	1
eksitasjon	positive	1
begeistre	positive	1
glade	positive	1
spenning	positive	1
spennende	positive	1
ekskludert	negative	1
unntatt	negative	1
ekskludering	negative	1
ekskrementer	negative	1
ulidelig	negative	1
unnskyld	negative	1
utførelse	negative	1
bøddel	negative	1
eksemplarisk	positive	1
eksempler på	negative	0
fritak	positive	1
pust ut	negative	0
pust ut	positive	0
eksos	negative	1
utmattet	negative	1
utmattelses	negative	1
formane	positive	1
formaning	positive	1
presserende	negative	1
eksil	negative	1
eksistens	positive	1
gå ut	negative	0
gå ut	positive	0
eksorsisme	negative	1
eksotisk	positive	1
utflyttende	negative	1
forvent	positive	1
forventning	positive	1
hensiktsmessig	positive	1
ekspedisjon	positive	1
utvise	negative	1
utgifts	negative	1
utgifter	negative	1
opplevd	positive	1
ekspert	positive	1
ekspertise	positive	1
utløper	negative	1
utløpt	negative	1
forklar	positive	1
eksplosivt	negative	1
eksplodere	negative	1
eksplosjons	negative	1
eksplosivt	negative	1
eksponert	negative	1
ekspropriasjon	negative	1
utvisning	negative	1
utsøkt	positive	1
utsøkt	positive	1
utvide	positive	1
omfattende	positive	1
utrydde	negative	1
utryddelse	negative	1
utdød	negative	1
slukk	negative	1
ekstra	positive	1
trekk ut	negative	0
trekke ut	positive	0
trekke ut	negative	0
utenrettslig	negative	1
ekstraordinært	positive	1
ekstremitet	negative	1
utvannet	positive	1
fabrikere	negative	1
fabrikasjon	negative	1
legge til rette for	negative	0
legge til rette for 1
fakta	positive	1
fakultetets	positive	1
falme	negative	1
avføring	negative	1
sviktende	negative	1
feil	negative	1
svak	positive	1
besvimelse	negative	1
ganske	positive	1
ganske	positive	1
farledegativ 0
fe-	positive	0
tro	positive	1
trofast	positive	1
troløs	negative	1
falske	negative	1
falle	negative	1
feilaktig	negative	1
feilslutning	negative	1
feilbar	negative	1
fallende	negative	1
brakk	negative	1
falskhet	negative	1
falskt	negative	1
forfalskning	negative	1
forfalske	negative	1
falskhet	negative	1
sviktende	negative	1
berømmelse	positive	1
kjent	positive	1
fortrolighet	positive	1
bli kjent med	negative	0
bli kjent med	positive	0
sult	negative	1
berømt	positive	1
kjent	positive	1
fanatisk	negative	1
fancy	positive	1
fanfare	positive	1
farse	negative	1
farcical	negative	1
fascinerende	positive	1
fascinasjon	positive	1
fasjonable	positive	1
fastende	negative	1
fett	negative	1
dødelig	negative	1
dødsfall	negative	1
skjebne	negative	1
utmattelses	negative	1
trøtt	negative	1
fett	negative	1
feil	negative	1
feilfri	positive	1
feil	negative	1
gunstig	positive	1
favoritt	positive	1
favorittisme	positive	1
fawn	negative	1
frykt	negative	1
fryktelig	negative	1
fryktelig	negative	1
frykter	negative	1
fryktløs	positive	1
prestasjon	positive	1
funksjon	positive	1
feber	negative	1
fekal	negative	1
avføring	negative	1
gebyr	negative	1
svak	negative	1
føler meg	negative	0
føler deg	positive	0
føler seg	negative	1
føler seg	positive	1
feined	negative	1
felicity	positive	1
falt	negative	1
andre	positive	1
fellesskap	positive	1
felon	negative	1
forbrytelses	negative	1
kvinnelig	positive	1
gjær	negative	1
voldsom	negative	1
voldsomhet	negative	1
fruktbar	positive	1
glød	positive	1
festival	positive	1
festlig	positive	1
fete	positive	1
feide	negative	1
føydalt	negative	1
føydalisme	negative	1
feberaktig	negative	1
fiasko	negative	1
fib	negative	1
ustadig	negative	1
fiktivt	negative	1
troskap	positive	1
fiend	negative	1
voldsom	negative	1
fiesta	positive	1
kjemp	negative	1
kjemper	negative	1
filibuster	negative	1
skitt	negative	1
skitten	negative	1
endelig	positive	1
finansnegat 0
fint	positive	1
finesse	positive	1
skytevåpen	negative	1
ildkule	positive	1
brannsikker	positive	1
fasthet	positive	1
førstefødt	positive	1
finanspolitisk 0
passer	negative	1
passer	positive	1
armatur	positive	1
slapp	negative	1
slapp	negative	1
slapp sositive 0
flagging	negative	1
flagrant	negative	1
flake	negative	1
klaff	negative	1
smigrende	positive	1
flatulens	negative	1
flagg	negative	1
feil	negative	1
loppe	negative	1
fly	negative	1
fleece	negative	1
flåte	positive	1
kjøttfull	negative	1
fleksibilitet	positive	1
vipp	negative	1
flørt	negative	1
flørt	positive	1
flog	negative	1
flopp	negative	1
blomster	positive	1
flyndre	negative	1
flytposisjon 1
blomstrende	positive	1
influensa	negative	1
svingninger	negative	1
skyll	positive	1
flyr	positive	1
fokus	positive	1
fôr	negative	0
fôr	positive	0
fiende	negative	1
foliert	negative	1
dårskap	negative	1
kjærlighet	positive	1
mat	positive	1
narr	negative	1
tåpelig	negative	1
dårskap	negative	1
fotball	positive	1
fôr	negative	1
fôr	positive	0
streif	negative	1
overbærenhet	positive	1
forby	negative	1
forbyr	negative	1
force	negative	1
tvunget	negative	1
tvangs	negative	1
fremover	positive	1
forkynnende	negative	1
utelukke	negative	1
forfedres	positive	1
over	negative	1
foregående	positive	1
utenlandsk	negative	1
utlendings	negative	1
formann	positive	1
forløper	positive	1
forutse	positive	1
forventet	positive	1
framsyn	positive	1
advarte	negative	1
tapte	negative	1
tapte	negative	1
tap av	negative	1
tap av tap 0
smi	positive	1
forfalskning	negative	1
glem	negative	1
tilgi	positive	1
tilgitt	positive	1
tilgivende	positive	1
glemt	negative	1
forlatt	negative	1
formativ	positive	1
formløs	negative	1
formel	positive	1
utukt	negative	1
forlate	negative	1
forlatt	negative	1
forte	positive	1
kommende	positive	1
styrke	positive	1
styrke	positive	1
hver uke	negative	0
to uker	positive	0
festnings	positive	1
heldig	positive	1
formue	positive	1
fremover	positive	1
stygg	negative	1
funnet	positive	1
grunnleggende	positive	1
fire ganger	negative	0
brudd	negative	1
skjøre	negative	1
velduftende	positive	1
svak	negative	1
ærlig	positive	1
ærlighet	positive	1
hektisk	negative	1
broderlig	positive	1
svindel	negative	1
uredelig	negative	1
fulle	negative	1
slå	negative	1
slitt	negative	1
freakish	negative	1
frihets	positive	1
fritt	positive	1
frysende	negative	1
frenetisk	negative	1
vanvittig	negative	1
vanvittig	negative	1
freskomegativ 0
førsteårsnegat 0
førsteårs-	positive	0
bekymre seg	negative	1
bekymre seg	positive	0
venn	positive	1
vennlig	positive	1
vennlig	positive	1
vennskaps	positive	1
redd	negative	1
skremme	negative	1
redd	negative	1
skremmende	negative	1
frigid	negative	1
frynsegang 0
sprø	positive	1
useriøs	negative	1
boltre seg	negative	0
boltre seg	positive	1
frontposisjon 0
forfrysnings	negative	1
skum	negative	1
rynke	negative	1
rynker	negative	1
nøysom	positive	1
fruktbart	positive	1
fruktløs	negative	1
frustrer	negative	1
frustrert	negative	1
frustrasjon	negative	1
fudge	negative	1
flyktig	negative	1
støttepunkt 0
oppfylle	positive	1
oppfyllelse	positive	1
fullt	positive	1
fullt	positive	1
fumle	negative	1
røyk	negative	1
fuming	negative	1
morsomt	positive	1
grunnleggende	positive	1
sopp	negative	1
funk	negative	1
rasende	negative	1
furor	negative	1
raseri	negative	1
sikring	positive	1
fusjons	positive	1
oppstyr	negative	1
masete	negative	1
nytteløst	negative	1
nytteløs	negative	1
gaby	negative	1
gag	negative	1
få	positive	1
får	positive	1
gangposisjon 0
galle	negative	1
galant	positive	1
galantisk	positive	1
galge	negative	1
veldig	positive	1
gamble	negative	1
gambler	negative	1
gambling	negative	1
gjeng	negative	1
gaol	negative	1
gap	negative	1
søppel	negative	1
hage	positive	1
garish	negative	1
granat	positive	1
pynt	negative	1
garnison	positive	1
gass ​​	negative	0
gash	negative	1
gisper	negative	1
gauche	negative	1
tøff	negative	1
gazette	positive	1
gir	positive	1
perle	positive	1
generelt	positive	1
generøsitet	positive	1
sjenerøs	positive	1
genial	positive	1
genialt	positive	1
gent	negative	1
mild	positive	1
gentleman	positive	1
mildhet	positive	1
gentry	positive	1
ekte	positive	1
geranium	positive	1
geriatrisk	negative	1
uhyggelig	negative	1
ghetto	negative	1
ghetto-	positive	0
spøkelses	negative	1
gibberish	negative	1
gave	positive	1
begavet	positive	1
gigantisk	positive	1
fnise	positive	1
bjelke	positive	1
gir	positive	1
is	negative	1
glad	positive	1
gjenskinn	negative	1
skarp	negative	1
glede	positive	1
glib	negative	1
gli	positive	1
glitrende	positive	1
glitrende	positive	1
dyster	negative	1
dystre	negative	1
forherligelse	positive	1
forherlig	positive	1
ære	positive	1
glans	positive	1
glød	positive	1
glødende	positive	1
glum	negative	1
glut	negative	1
fråtsende	negative	1
glyserin-	negative	0
glyserin-	positive	0
gnome	negative	1
goblin	negative	1
gud	positive	1
gudfar negativ
gudfar positiv
gudløs	negative	1
gudfryktige	positive	1
god gave	positive	1
gull	positive	1
gonoré	negative	1
gonoré	positive	0
goo	negative	1
bra	positive	1
godt	positive	1
godhet	positive	1
varer	positive	1
goodwill	positive	1
gore	negative	1
juvet	negative	1
nydelig	positive	1
gorilla	negative	1
gory	negative	1
evangelisk	positive	1
sladder	negative	1
hull	negative	1
gikt	negative	1
styr	positive	1
regjerings	negative	1
grip	negative	1
nåde	positive	1
grasiøs	positive	1
nådig	positive	1
nådig	positive	1
oppgradering	positive	1
barnebarn	positive	1
storhet	positive	1
bestemor	positive	1
gi	positive	1
gitt	positive	1
gripe	negative	1
rist	negative	1
revet	negative	1
takknemlig	positive	1
tilfredsstille	positive	1
gitter	negative	1
takknemlighet	positive	1
alvorlig	negative	1
større	positive	1
storhet	positive	1
grådighet	negative	1
grådig	negative	1
grønn	positive	1
hilsen	positive	1
selskapelig	positive	1
granat	negative	1
sorg	negative	1
klage	negative	1
sørge	negative	1
alvorlig	negative	1
dystre	negative	1
smuss	negative	1
skitten	negative	1
glis	positive	1
sliping	negative	1
uhyggelig	negative	1
grist	positive	1
korn	positive	1
grizzly	negative	1
stønn	negative	1
famle	negative	1
brutto	negative	1
grotesk	negative	1
jordet	negative	1
grunnløs	negative	1
grunnarbeid	positive	1
bli	positive	1
knurring	negative	1
knurrende	negative	1
vekst	positive	1
nag	negative	1
motvillig	negative	1
grusom	negative	1
grov	negative	1
mumle	negative	1
gretten	negative	1
garanterer	positive	1
vakt	positive	1
verge	positive	1
vergemål	positive	1
gubernatorial	positive	1
gerilja	negative	1
veiledning	positive	1
guide	positive	1
guidebok	positive	1
svik	negative	1
giljotin	negative	1
skyld	negative	1
skyldig	negative	1
guinea-	negative	0
guinea-	positive	0
forkledning	negative	1
måke	negative	1
godtroende	negative	1
pistol	negative	1
guru	positive	1
gush	negative	1
vindkast 0
guts	positive	1
surt	negative	1
gymnast	positive	1
sigøyner	negative	1
habitat	positive	1
hag	negative	1
haggard	negative	1
hagl	negative	1
hagl	positive	1
hårete	negative	1
hale	positive	1
halvveis	negative	1
hallusinasjon	negative	1
halo-	negative	0
halter	negative	1
stoppe	negative	1
hindre	negative	1
hamstring	negative	1
handikap	negative	1
praktisk	positive	1
hengende	negative	1
hangman	negative	1
lykkelig	positive	1
lykke	positive	1
lykkelig	positive	1
trakassere	negative	1
forkynner	negative	1
herdet	negative	1
hardhet	negative	1
motgang	negative	1
hardfør	positive	1
skøn	negative	1
skade	negative	1
skadelig	negative	1
munnspill-	negative	0
munnspill positiv
harmonisk	positive	1
harmoni	positive	1
opprivende	negative	1
harry	negative	1
hardhet	negative	1
høst	positive	1
hash	negative	1
hasj-	negative	1
skynd deg	positive	0
forhastet	negative	1
hater	negative	1
hatefull	negative	1
hater	negative	1
hat	negative	1
hovmodige	negative	1
hjemsøke	negative	1
hjemsøkt	negative	1
ha	positive	1
kaos	negative	1
fare	negative	1
farlig	negative	1
dis	negative	1
hodepine	negative	1
fremgangs	positive	1
heftig	negative	1
helbrede	positive	1
helbredende	positive	1
sunn	positive	1
sunn	positive	1
høre	negative	1
hørselsposisjon 0
hørsels	negative	1
likegående	negative	1
hjertesorg	negative	1
halsbrann	negative	1
inderlig	positive	1
ildsted	positive	1
hjertelig	positive	1
hjerteløs	negative	1
varmeapparat negativ
hedensk	negative	1
himmelsk	positive	1
himmelen	positive	1
sterkt	negative	1
hedonisme	negative	1
hedonisme	positive	1
hæl	negative	1
heftig	positive	1
kvige-	negative	0
øke	negative	1
avskyelig	negative	1
helvete	negative	1
helvete	negative	1
hjelm	positive	1
hjelper	positive	1
nyttig	positive	1
hjelpeløs	negative	1
hjelpeløshet	negative	1
blødning	negative	1
hemoroider	negative	1
urte-	negative	0
urte-	negative	0
urte	positive	1
kjetteri	negative	1
kjetter	negative	1
hermafroditt	negative	1
helt	positive	1
heroisk	positive	1
heroiske	positive	1
heroin	negative	1
heltinne	positive	1
heltemot	positive	1
herpes	negative	1
herpesvirus	negative	1
nølende	negative	1
storhetstid	positive	1
skjult	negative	1
avskyelig	negative	1
gjemmer seg	positive	0
høyeste	negative	1
høyest	positive	1
morsom	positive	1
morsomhet	positive	1
hindrer	negative	1
hindring	negative	1
hippie	negative	1
ansette	positive	1
susende	negative	1
hvesende	negative	1
treff	negative	1
hittil	negative	1
bikube	negative	1
hes	negative	1
varsel	negative	1
hoax	negative	1
hobby	positive	1
hobo	negative	1
hog	negative	1
ferie	positive	1
hellighet	positive	1
hul	negative	1
holocaust-	negative	1
holocaust-	positive	0
hellig	positive	1
hyllest sositive 1
hjemløse	negative	1
hjemlengsel	negative	1
draps	negative	1
draps	negative	1
homologi	positive	1
homofili	negative	1
ærlig	positive	1
ærlighet	positive	1
kjære	positive	1
bryllupsreise	positive	1
ære	positive	1
hederlig	positive	1
hette	negative	1
hekta	negative	1
hoot	negative	1
håper	positive	1
håpefull	positive	1
håpløst	negative	1
håpløshet	negative	1
horde	negative	1
horisont	positive	1
fryktelig	negative	1
fryktelig	negative	1
vemmelig	negative	1
forferdelig	negative	1
forferdet	negative	1
forferdelig	negative	1
horror	negative	1
grufulle	negative	1
hestesko-	negative	0
gjestfrihet	positive	1
gissel	negative	1
fiendtlig	negative	1
fiendtlighet	negative	1
fiendtlighet	negative	1
husholdnings	positive	1
rengjøring	positive	1
hyl	negative	1
uansett hvilken	negative	0
uansett hvor	positive	0
huff	negative	1
klem	positive	1
human	positive	1
humanitær	positive	1
menneskehetens	positive	1
ydmyk	negative	1
ydmyk	positive	1
ydmyk	positive	1
ydmyk	positive	1
humbug	negative	1
ydmykende	negative	1
ydmykende	negative	1
ydmykelse	negative	1
ydmykhet	positive	1
humoristisk	positive	1
humoristisk	positive	1
fornemmelse	negative	1
sulten	negative	1
jeger	negative	1
jakt	negative	1
jakt	positive	e 0
hurra	positive	1
orkan	negative	1
hastet	negative	1
skynd deg	negative	0
skynd deg	positive	0
skadet	negative	1
sårende	negative	1
skade	negative	1
oppdrett	positive	1
hysj	positive	1
stille lyd 0
stille lyd 0
hustler	negative	1
hytte	positive	1
hydra	negative	1
hydrocefalus	negative	1
hygienisk	positive	1
salme	positive	1
hype	negative	1
hyperbole	negative	1
hykleri	negative	1
hykler	negative	1
hyklerisk	negative	1
hysteri	negative	1
hysterisk	negative	1
idealistisk	positive	1
idioti	negative	1
idiot	negative	1
idiotisk	negative	1
tomgangs	negative	1
idol	positive	1
avgudsdyrkelse	negative	1
uvitenhet	negative	1
uvitende	negative	1
ignorere	negative	1
dårlig	negative	1
ulovlig	negative	1
ulovlighet	negative	1
uleselig	negative	1
uekte	negative	1
ulovlig	negative	1
analfabeter	negative	1
sykdoms	negative	1
ulogisk	negative	1
belyse	positive	1
belysning	positive	1
illusjons	negative	1
illustrer	positive	1
strålende	positive	1
bilderegistrering 0
fantasifull	positive	1
forestill deg	negative	0
forestill deg	positive	0
forestilt seg	positive	0
forestille seg	negative	0
forestille seg	positive	0
imitert	negative	1
imitasjon	negative	1
ulastelig	positive	1
umoden	negative	1
umodenhet	negative	1
umiddelbart	negative	1
umiddelbart	positive	1
enormt	positive	1
fordyp	positive	1
nært forestående	negative	0
nært forestående	positive	0
umoralsk	negative	1
umoral	negative	1
udødelig	positive	1
immovable	negative	1
ubevegelige	positive	1
svekke	negative	1
nedskrivning	negative	1
formidle	positive	1
upartisk	positive	1
upartiskhet	positive	1
ufremkommelig	negative	1
utålmodighets	negative	1
utålmodig	negative	1
anklage	negative	1
anklage	negative	1
upåklagelig	positive	1
hindre	negative	1
ufullkommenhet	negative	1
ufullstendig	negative	1
etterligne	negative	1
imitasjon	negative	1
ugjennomtrengelig	positive	1
uforsonlig	negative	1
implisere	negative	1
uhøflig	negative	1
viktighet	positive	1
viktig	positive	1
pålegg	negative	1
umulig	negative	1
impotens	negative	1
impotent	negative	1
impound	negative	1
upraktisk	negative	1
imponere	positive	1
inntrykk	positive	1
fengsels	negative	1
fengslet	negative	1
fengsel	negative	1
upassende	negative	1
forbedre	positive	1
forbedret	positive	1
forbedring	positive	1
forbedrer	positive	1
improvisere	positive	1
uforsiktig	negative	1
straffri straff 0
urent	negative	1
urenhet	negative	1
imputasjon	negative	1
manglende evne	negative	1
manglende evne	positive	0
utilgjengelig	negative	1
unøyaktig	negative	1
passivitet	negative	1
inaktivitet	negative	1
utilstrekkelig	negative	1
utilstrekkelig	negative	1
ikke tillatt	negative	1
ikke tillatt	positive	0
umistelig	positive	1
inane	negative	1
ubrukelig	negative	1
upassende	negative	1
uoppmerksom	negative	1
uhørlig	negative	1
innvielse	positive	1
uberegnelig	negative	1
inhabilitet	negative	1
fengsling	negative	1
incase	negative	1
incendiar	negative	1
brennende sositive 0
røkelse	negative	1
uopphørlig	negative	1
incest	negative	1
incestuøs	negative	1
forbrenning	negative	1
skarp	positive	1
oppfordre	negative	1
dårlig	negative	1
inkluderer	positive	1
inkludert	positive	1
inkludert	positive	1
inkluderende	positive	1
usammenhengende	negative	1
inntekts	negative	1
inntekts	positive	1
inkompatibel	negative	1
inkompetanse	negative	1
inkompetent	negative	1
ufullstendighet	negative	1
uforståelig	negative	1
inkongruøs	negative	1
ubetydelig	negative	1
hensynsløs	negative	1
inkonsekvens	negative	1
upraktisk	negative	1
feil	negative	1
øke	positive	1
vantro	negative	1
inkriminering	negative	1
inkubus	negative	1
pådrar seg	negative	1
pådrar seg	positive	0
uhelbredelig	negative	1
innfall	negative	1
usømmelig	negative	1
ubesluttsomhet	negative	1
ubesluttsom	negative	1
uforsvarlig	negative	1
uutslettelig	positive	1
skadesløs skade 1
skadesløs 0
skadesløsholdelse 1
fordypning	negative	1
uavhengighets	positive	1
uforgjengelig	positive	1
ubestemt	negative	1
tiltale	negative	1
tiltale	negative	1
likegyldighet	negative	1
nødig	negative	1
dårlig fordøyelsesbesvær 0
dårlig fordøyelsesbesvær 0
indignert	negative	1
indignasjon	negative	1
utydelig	negative	1
umulig å skille	negative	0
individualitets	positive	1
indoktrinering	negative	1
indolent	negative	1
ukuelig	positive	1
ineffektivt	positive	1
ineffektiv	negative	1
ineffektiv	negative	1
ineffektivitet	negative	1
ineffektiv	negative	1
ikke kvalifisert	negative	0
ikke kvalifisert	positive	0
udugelig	negative	1
ineptitude	negative	1
ulikhet	negative	1
ulik	negative	1
inert	negative	1
unnskyldelig	negative	1
billig	positive	1
uerfarenhet	negative	1
uerfaren	negative	1
uforklarlig	negative	1
ufeilbarlig	positive	1
beryktet	negative	1
infamy	negative	1
spedbarns	positive	1
barnemord	negative	1
infantilt	negative	1
infarkt	negative	1
infisere	negative	1
infeksjons	negative	1
smittsom	negative	1
dårligere	negative	1
underlegenhet	negative	1
inferno	negative	1
infertilitet	negative	1
infestasjon	negative	1
utro	negative	1
utroskap	negative	1
infiltrasjon	negative	1
infiltrasjon	positive	1
uendelig	positive	1
uendelig minimal 0
uendelig	positive	1
svak	negative	1
svakhet	negative	1
betennelse	negative	1
oppblåst	negative	1
inflasjon	negative	1
påføre	negative	1
påføring	negative	1
påvirke	negative	1
påvirke	positive	1
innflytelsesrike	positive	1
influensa	negative	1
informasjon	positive	1
informatør	negative	1
infrasjons	negative	1
sjelden	negative	1
overtredelse	negative	1
genialt	positive	1
pust inn	negative	0
arvs	positive	1
hemme	negative	1
ugjestmilde	negative	1
umenneskelig	negative	1
umenneskelig	negative	1
inimical	negative	1
uforlignelig	positive	1
misgjerning	negative	1
påbud	negative	1
skade	negative	1
skadet	negative	1
skadelig	negative	1
skade	negative	1
urettferdighet	negative	1
innsatt	negative	1
uskyldig	positive	1
uskyldig	positive	1
uskyldig	positive	1
uskadelig	positive	1
innover	positive	1
innovasjons	positive	1
inoperativt	negative	1
spørrer	positive	1
nysgjerrig	positive	1
sinnsykt	negative	1
galskap	negative	1
usikker	negative	1
usikkerhet	negative	1
uatskillelig	positive	1
sett inn	negative	0
sett inn	positive	0
satt inn	negative	0
satt inn	positive	0
inne i	negative	0
snikende	negative	1
insignier	positive	1
ubetydelig	negative	1
ubetydelig	negative	1
magert	negative	1
insister på	negative	0
frekk	negative	1
insolvens	negative	1
insolvent	negative	1
inspektør	positive	1
inspirasjon	positive	1
inspirere	positive	1
inspirert	positive	1
ustabilitet	negative	1
initiere	negative	1
tilskyndelse	negative	1
instinktiv	positive	1
instruere	positive	1
instruksjon	positive	1
instruktør	positive	1
instrumental	positive	1
insuffisiens	negative	1
utilstrekkelig	negative	1
utilstrekkelig	negative	1
fornærmelse	negative	1
fornærmende	negative	1
forsikre deg om	positive	1
opprørs	negative	1
uoverstigelig	negative	1
opprørs	negative	1
intakt	positive	1
integritets	positive	1
intellektuell	positive	1
intellektuell	positive	1
intelligens	positive	1
intelligent	positive	1
har til hensikt å være	negative	0
har til hensikt å være	positive	0
ment	positive	1
intens	negative	1
intenst	positive	1
inter	negative	1
gå forbi	negative	0
gå forbi	positive	0
fange opp	positive	0
utveksling negativ0
samleie	positive	1
gjensidig avhengighet	negative	0
gjensidig avhengighet	positive	0
gjensidig avhengig	negative	0
gjensidig avhengig	positive	0
forbud	negative	1
rente	positive	1
interessert	positive	1
interessant	positive	1
interferens	negative	1
interiør	positive	1
samtale	positive	1
mellomspill	positive	1
interment	negative	1
uendelig	negative	1
uendelig	positive	1
avbryt	negative	1
avbrutt	negative	1
intervensjons	negative	1
intervensjons	positive	1
intestat	negative	1
intimt	positive	1
skremme	negative	1
skremsel	negative	1
utålelig	negative	1
intoleranse	negative	1
intolerant	negative	1
intonasjon	positive	1
beruset	negative	1
uhåndterlig	negative	1
fryktløs	positive	1
intriger	negative	1
inntrenger	negative	1
innbrudd	negative	1
påtrengende	negative	1
intuisjon	positive	1
intuitivt	positive	1
invadere	negative	1
inntrenger	negative	1
ugyldig	negative	1
ugyldiggjøring	negative	1
ugyldighet	negative	1
alltid	positive	1
invasjon	negative	1
oppfinnsomme	positive	1
oppfinner	positive	1
undersøk	positive	1
etterforsker-	negative	0
styrke	positive	1
invitasjon	positive	1
inviter	positive	1
innbydende	positive	1
faktura e	negative	0
ufrivillig	negative	1
involusjon	negative	1
irriterende	negative	1
ire	negative	1
jern	positive	1
strykejern	negative	1
strykejern positive
irrasjonell	negative	1
irrasjonell	negative	1
uforsonlig	negative	1
irredusible	positive	1
ugjendrivelig	positive	1
uregelmessig	negative	1
uregelmessighet	negative	1
irrelevant	negative	1
uopprettelig	negative	1
uansvarlig	negative	1
ærbødig	negative	1
ugjenkallelig	negative	1
irritabilitet	negative	1
irritabel	negative	1
irriterende	negative	1
irritasjon	negative	1
ø-	negative	0
ø-	positive	0
isolert	negative	1
isolasjon	negative	1
jabber	negative	1
jackpot	positive	1
fengsel	negative	1
papirstopp 1
sjargong	negative	1
skurrende	negative	1
gulsott	negative	1
sjalu	negative	1
sjalusi	negative	1
gelé	negative	0
gelé	positive	0
fare	negative	1
sette	positive	0 i fare
fare	negative	1
morsomt	positive	1
jobb	positive	1
john	negative	1
bli med	negative	0
bli	positive	1
ble med	negative	0
ble med	positive	1
vits	negative	1
joker	positive	1
tuller	positive	1
jornada	negative	1
journalist	positive	1
reise	positive	1
jovial	positive	1
glede	positive	1
gledelig	positive	1
gledelig	positive	1
jublende	positive	1
jubileums	positive	1
dommer sositive 0
å bedømme	positive	0
rettslig	positive	1
klokt	positive	1
virvar	negative	1
hopp	positive	1
søppel	negative	1
junta	negative	1
rettferdighets	positive	1
forsvarlig	positive	1
begrunnelse	positive	1
ungdoms	negative	1
sidestillingsposisjon 0
kenguru-	negative	0
kenguru-	positive	0
minnesmerke	positive	1
ken	positive	1
kern	negative	1
hoved	negative		negative	0
grunnleggende	positive	1
keystone	positive	1
spark	negative	1
kidnappe	negative	1
drepe	negative	1
drepe	negative	1
snill	positive	1
vennlig	positive	1
slekt	positive	1
king	positive	1
kyss	positive	1
kite	negative	1
kattunge	positive	1
dyktig	positive	1
knell	negative	1
ridder	positive	1
knyttet	negative	1
å vite	negative	0
å vite	positive	1
kunnskaps	positive	1
kudos	positive	1
arbeidskraft	positive	1
arbeidet	negative	1
arbeidskrevende	negative	1
labyrint	negative	1
blonder	negative	1
blonder	positive	1
mangler	negative	1
mangler	negative	1
lite	negative	1
lastet	negative	1
lag	negative	1
henger	negative	1
lair	negative	1
lam	positive	1
beklager	negative	1
land	positive	1
landet	positive	1
landingsposisjon 0
skred	negative	1
sløv	negative	1
forsvinne	negative	1
sløvende	negative	1
bortfall	negative	1
tyveri	negative	1
laser	positive	1
vippe	negative	1
sent	negative	1
forsinkelse	negative	1
sent posisjon 0
latent	negative	1
latrines	negative	1
prisverdig	positive	1
le	positive	1
latterlig	negative	1
ler	positive	1
latter	positive	1
lansere	positive	1
prisvinner	positive	1
laurbær	positive	1
laurbær	positive	1
lava	negative	1
overdådige	positive	1
lovlig	positive	1
lovløshet	negative	1
søksmål	negative	1
advokat	negative	1
slapp	negative	1
avføringsmiddel	negative	1
lat	negative	1
føre	positive	1
leder	positive	1
pakningsvedlegg 0
liga	positive	1
lekkasje	negative	1
lekkasje	negative	1
lekkasje	negative	1
lente seg	negative	0
lente seg	positive	0
lær	positive	1
lærings	positive	1
la	negative	1
foreleser	positive	1
leech	negative	1
igler	negative	1
lær	negative	1
spillerom	positive	1
juridisk	positive	1
legalisert	positive	1
legendarisk	positive	1
lesbarhet	positive	1
leselig	positive	1
legitimitet positikke	positive	0
land	positive	1
landet	positive	1
landingsposisjon 0
skred	negative	1
sløv	negative	1
forsvinne	negative	1
sløvende	negative	1
bortfall	negative	1
tyveri	negative	1
laser	positive	1
vippe	negative	1
sent	negative	1
forsinkelse	negative	1
sent posisjon 0
latent	negative	1
latrines	negative	1
prisverdig	positive	1
le	positive	1
latterlig	negative	1
ler	positive	1
latter	positive	1
lansere	positive	1
prisvinner	positive	1
laurbær	positive	1
laurbær	positive	1
lava	negative	1
overdådige	positive	1
lovlig	positive	1
lovløshet	negative	1
søksmål	negative	1
advokat	negative	1
slapp	negative	1
avføringsmiddel	negative	1
lat	negative	1
føre	positive	1
leder	positive	1
pakningsvedlegg 0
liga	positive	1
lekkasje	negative	1
lekkasje	negative	1
lekkasje	negative	1
lente seg	negative	0
lente seg	positive	0
lær	positive	1
lærings	positive	1
la	negative	1
foreleser	positive	1
leech	negative	1
igler	negative	1
lær	negative	1
spillerom	positive	1
juridisk	positive	1
legalisert	positive	1
legendarisk	positive	1
lesbarhet	positive	1
leselig	positive	1
legitimitet positsløv	negative	1
bokstavelig talt	negative	0
bokstavelig talt	positive	0
smidig	positive	1
søksmål	negative	1
rettssak	negative	1
søksmål	negative	1
litigious	negative	1
søppel	negative	1
livid	negative	1
lama-	negative	0
brød	negative	1
loafer	negative	1
avsky	negative	1
avsky	negative	1
avsky	negative	1
avskyelig	negative	1
lobbyist	negative	1
låsing	negative	1
gresshoppe	negative	1
høy	negative	1
logisk	positive	1
ensomhet	negative	1
ensom	negative	1
ensom	negative	1
lang levetid	negative	0
lang levetid	positive	1
loo	negative	1
vevstol	negative	1
loon	negative	1
loony	negative	1
plyndring	negative	1
herre	negative	1
herre	positive	1
herredømme	positive	1
miste	negative	1
miste	negative	1
tap	negative	1
mistet	negative	1
lydstyrke	negative	1
salong	negative	1
lus	negative	1
elskelig	positive	1
kjærlighets	positive	1
nydelig	positive	1
elskov	positive	1
elsker	positive	1
kjærlig	positive	1
lavere	negative	1
senking	negative	1
laveste	negative	1
lavlands	negative	1
lite	negative	1
lojale	positive	1
lojalitets	positive	1
lykke	positive	1
heldig	positive	1
latterlig	negative	1
tunge	negative	1
klump	negative	1
klumpete	negative	1
galskap	negative	1
galning	negative	1
svak	negative	1
lokke	negative	1
urolig	negative	1
lur	negative	1
lurer	negative	1
saftig	positive	1
frodig	negative	1
lyst	negative	1
glans	positive	1
lystig	negative	1
skinnende	positive	1
frodig	positive	1
luksuriøst	positive	1
luksus	positive	1
liggende	negative	1
lynch	negative	1
lyro	positive	1
lyrisk	positive	1
blonder	negative	1
gal	negative	1
gal	negative	1
gal gal 1
gal gal 0
galskap	negative	1
mafia	negative	1
maggot	negative	1
magisk	positive	1
magnet	positive	1
magnetisme	positive	1
magnetitt	positive	1
storslått	positive	1
fantastisk	positive	1
jomfru	positive	1
viktigste	positive	1
bærebjelke	positive	1
majestetisk	positive	1
majestet	positive	1
stor	positive	1
majoritets	positive	1
midlertidig	negative	1
sykdoms	negative	1
utilpashed	negative	1
malaria	negative	1
malaria-	positive	0
ondskapsfull	negative	1
misdannelse	negative	1
ondskaps	negative	1
ondsinnet	negative	1
ondartet	negative	1
malignitet	negative	1
ondartet	negative	1
feilbehandling	negative	1
klare	positive	1
ledelsens	positive	1
mandamus	negative	1
mandarin	positive	1
mange	negative	1
mangel	negative	1
mango-	negative	0
mango-	positive	0
manndom	positive	1
mani	negative	1
galning	negative	1
galning	negative	1
manifestert	positive	1
manipulere	negative	1
manipulasjon	negative	1
mannlig	positive	1
manna	positive	1
oppmuntret	positive	1
manners	positive	1
drap	negative	1
produsentens	positive	1
gjødsel	negative	1
kartposisjon 0
mar	negative	1
mars	positive	1
margin	negative	1
markert	positive	1
salgbar	positive	1
rødbrun	negative	1
teltposisjon 0
markis	positive	1
ekteskap	positive	1
marg	positive	1
gifte seg	negative	0
gifte seg	positive	1
marskalk	positive	1
martingale	negative	1
martyr	negative	1
martyrdød	negative	1
vidunder	positive	1
fantastisk	positive	1
fantastisk	positive	1
maskulin	positive	1
masochisme	negative	1
massakre	negative	1
massasje	positive	1
mestre	positive	1
mesterverk	positive	1
mestring	positive	1
kompis	positive	1
materialisme	negative	1
materialistisk	negative	1
materialisere seg	positive	0
materiellposisjon 0
mors	negative	1
mors	positive	1
ekteskaps	positive	1
matrons	positive	1
maksimal	positive	1
ordfører	positive	1
eng	positive	1
slyngende	negative	1
som betyr	negative	0
som betyr	positive	0
meningsløs	negative	1
i mellomtiden	negative	0
i mellomtiden	positive	0
meslinger	negative	1
målt	positive	1
blande seg	negative	1
blande seg	positive	0
blande seg	negative	0
formidle	positive	1
mekling	positive	1
mekler	positive	1
medisinsk	positive	1
middelmådig	negative	1
middelmådighet	negative	1
meditere	positive	1
middelhavs	positive	1
medley	positive	1
melankolsk	negative	1
melankolsk	negative	1
nærkamp	negative	1
nærkamp positiv
melodrama	negative	1
nedsmelting	negative	1
minner	positive	1
minneverdig	positive	1
trussel	negative	1
truende	negative	1
fikser	positive	1
menial	negative	1
menstruasjon	positive	1
mentor	positive	1
leiesoldat	negative	1
barmhjertig	positive	1
nådeløs	negative	1
barmhjertighets	positive	1
slå sammen	positive	1
fortjeneste	positive	1
meritterende	positive	1
lystig	positive	1
rot	negative	1
rotete	negative	1
metastase	negative	1
metanol	negative	1
storby	positive	1
mettle	positive	1
mikroskopi	positive	1
midtposisjon 0
jordmor	negative	1
jordmor	positive	1
jordmor	positive	1
mektig	positive	1
mugg	negative	1
milits	negative	1
mime-	positive	1
etterligning	negative	1
oppmerksom	positive	1
oppmerksomhet	positive	1
minimer	negative	1
minimum	negative	1
tjeneste	positive	1
minoritets	negative	1
minus minus 0
mirakel	positive	1
mirakuløst	positive	1
myr	negative	1
glede	positive	1
misbruk av	negative	0
dårlig oppførsel	negative	1
dårlig oppførsel	positive	0
spontanabort 1
ugagn	negative	1
rampete	negative	1
misforståelse	negative	1
forseelse	negative	1
dårlig oppførsel 0
elendig	negative	1
elendig	negative	1
elendighets	negative	1
ulykkes	negative	1
misvisende	negative	1
uhell	negative	1
feiltolkning	negative	1
villede	negative	1
villedende	negative	1
dårlig forvaltning	negative	1
dårlig ledelse	positive	0
uoverensstemmelse	negative	1
feil samsvar 0
feil samsvar 0
feilaktig	negative	1
feilplassering	negative	1
feilplassert	negative	1
feilaktig fremstille	negative	1
feilaktig fremstilling av	positive	0
feil fremstilling	negative	1
feil fremstilling	positive	0
feil fremlagt	negative	1
feil fremlagt	positive	0
mangler	negative	1
misjonær	positive	1
feilinformasjon	negative	1
feil	negative	1
feil	negative	1
elskerinne	negative	1
mistillit	negative	1
misforstå	negative	1
misforståelse	negative	1
misbruk	negative	1
midd	negative	1
mobbe	negative	1
spott	negative	1
hånende	negative	1
modell	positive	1
moderat	positive	1
moderator	positive	1
beskjeden	positive	1
beskjedenhet	positive	1
overgrep	negative	1
momentum	positive	1
monetær	positive	1
penger	positive	1
munk	positive	1
monokrom	negative	1
monogami-	positive	0
monopol	negative	1
monsun	negative	1
monster	negative	1
monstrosity	negative	1
monument	positive	1
humørsyk	negative	1
Mote	negative	1
moralsk	positive	1
moral	positive	1
moral	positive	1
sykelig	negative	1
sykelighet	negative	1
likhus	negative	1
dødelig	negative	1
idiot	negative	1
moronic	negative	1
bit	negative	1
dødelig	negative	1
dødelighet	negative	1
mørtel	positive	1
mortifikasjon	negative	1
likhus	negative	1
mygg	negative	1
mosegrad 0
mor	negative	1
mor	positive	1
morskap	positive	1
motiv	positive	1
sørge	negative	1
sørgelig	negative	1
sorg	negative	1
bevegelige	positive	1
bevege seg	negative	0
bevege seg	positive	0
mover	positive	1
beveger seg	negative	0
beveger seg	positive	0
muck	negative	1
slam	negative	1
rot	negative	1
forvirret	negative	1
gjørmete	negative	1
muff	negative	1
krus	negative	1
krus	positive	1
muldyr	negative	1
mamma	negative	1
mumle	negative	1
kusma	negative	1
draps	negative	1
morder	negative	1
morderisk	negative	1
skummel	negative	1
muskuløs	positive	1
musikk	positive	1
musikalsk	positive	1
muss	negative	1
muggen	negative	1
muterbar	positive	1
mutant	negative	1
lemlestet	negative	1
lemlestelse	negative	1
mytteri	negative	1
mutter	negative	1
gjensidig	positive	1
snute	negative	1
nærsynthet	negative	1
nab	negative	1
nag	negative	1
naivt	negative	1
navnløs	negative	1
lur	positive	1
bleie	negative	1
narkotisk	negative	1
ekkel	negative	1
fødselsposisjon 0
naturforsker	positive	1
slem	negative	1
kvalme	negative	1
kvalm	negative	1
navigerbar ositive 1
nei	negative	1
pent	positive	1
nektar	positive	1
nødvendig	negative	1
nål	positive	1
trengende	negative	1
ondskapsfull	negative	1
negasjon	negative	1
forsømmelse	negative	1
neglisjert	negative	1
neglisjering	negative	1
forsømmelse av	positive	0
uaktsomhet	negative	1
uaktsom	negative	1
uaktsomt	negative	1
forhandle	positive	1
forhandler	positive	1
neger	negative	1
nabo-	negative	0
nabo	positive	1
nepotisme	negative	1
nerve	positive	1
nervøs	negative	1
nestle	positive	1
nederste	negative	1
nettle	negative	1
nevralgi	negative	1
nevrose	negative	1
nevrotisk	negative	1
nikotin-	negative	1
neger	negative	1
mareritt	negative	1
nihilisme	negative	1
adel	positive	1
edel	positive	1
adelsmann	positive	1
støy	negative	1
støyende	negative	1
nominasjon	positive	1
ikke-	positive	0
avvik	negative	1
ikke-eksisterende	negative	0
ikke-eksisterende	positive	0
manglende betaling 0
manglende betaling 0
ikke-hjemmehørende	negative	0
ikke-bosatt	positive	0
tull	negative	1
meningsløs	negative	1
løkke	negative	1
normalitets	positive	1
nostalgjeg er	positive	0
bemerkelsesverdig	positive	1
bemerkelsesverdige	positive	1
bemerket seg	positive	1
ingenting	negative	1
legg merke til	negative	0
forestilling	positive	1
beryktelses	negative	1
beryktelses	positive	1
til tross for	negative	0
til tross for	positive	0
gi næring til	negative	0
gi næring til	positive	0
næring	positive	1
i dag	negative	0
i dag	positive	0
skadelig	negative	1
kjerne-	negative	0
generende	negative	1
null	negative	1
oppheve	negative	1
nummen	negative	1
tall	positive	1
nummenhet	negative	1
nonne	negative	1
sykepleier	positive	1
barnehage	positive	1
pleie	positive	1
muskat	negative		negative	0
næringsrik	positive	1
nærings	negative		negative	0
oaf	negative	1
eik	positive	1
oase-	positive	1
ed	positive	1
lydighet	positive	1
overvektige	negative	1
fedme	negative	1
obi	negative	1
obit	negative	1
nekrolog	negative	1
innvending	negative	1
kritikkverdig	negative	1
objektiv	positive	1
forplikte	negative	1
forpliktende	positive	1
obligatorisk	negative	1
utslette	negative	1
utslettet	negative	1
utslettelse	negative	1
glemsel	negative	1
motbydelig	negative	1
obo-	positive	0
uanstendig	negative	1
uanstendighet	negative	1
uklarhet	negative	1
observant	positive	1
hindring	negative	1
hardnakket	negative	1
hindre	negative	1
hindring	negative	1
hindrende	negative	1
oppnåelig	positive	1
stump	negative	1
åpenbart	positive	1
okkult	negative	1
beboer	positive	1
yrke	positive	1
okkupere	positive	1
oddity	negative	1
odious	negative	1
lukt	negative	1
fornærme	negative	1
fornærmet	negative	1
lovbryter	negative	1
lovbrudd	negative	1
støtende	negative	1
tilby	positive	1
offhand	negative	1
offiser	positive	1
forskjøvet	positive	1
offshoot	positive	1
ogre	negative	1
olfaktorisk	negative	1
oligarki	negative	1
omega-	negative	0
omega-	positive	0
omen	negative	1
illevarslende	negative	1
utelat	negative	1
omnibus-	positive	0
allmakt	negative	1
allmektig	positive	1
allvitende	positive	1
belastende	negative	1
seg selv	negative	0
onus	negative	1
oser	negative	1
oser av	positive	0
ugjennomsiktig	negative	1
åpenhet	positive	1
opera	positive	1
operatør	negative	1
opiat	negative	1
meningsfull	negative	1
opium	negative	1
motstander	negative	1
hensiktsmessig	positive	1
mulighet	positive	1
motsette seg	negative	1
motsette seg	positive	0
motsatt	negative	1
opposisjon	negative	1
undertrykke	negative	1
undertrykkelse	negative	1
undertrykkende	negative	1
undertrykker	negative	1
optimistisk	positive	1
alternativ	positive	1
valgfri	positive	1
orakelegativt 0
orakel	positive	1
orasjon	positive	1
ork	negative	1
orkester	positive	1
ordinert	positive	1
prøvelse	negative	1
ryddig	positive	1
ordinering	positive	1
ordnance	negative	1
organisk	positive	1
organisasjons	positive	1
organisere	positive	1
organisert	positive	1
orgasme	positive	1
originalitet	positive	1
stammer fra	negative	0
stammer fra	positive	0
ornamenterte	positive	1
utsmykkede	positive	1
foreldreløs	negative	1
tilsynelatende	negative	1
kast	negative	1
utbrudd	negative	1
utbrudd	positive	1
utstøtt	negative	1
utfall	positive	1
skrik	negative	1
overgå	positive	1
vokse ut	negative	0
vokser ut	positive	0
uthus	negative	1
outlandish	negative	1
ulovlig	negative	1
over antall	negative	0
over antall	positive	0
opprørende	negative	1
utestående	negative	1
utestående	positive	1
utad	positive	1
ovasjon	negative	1
anmassende	negative	1
overbelastning	negative	1
overskyet	negative	1
overdreven	negative	1
overdose	negative	1
forsinket	negative	1
overvurdert	negative	1
overløps	negative	1
gjengrodd	negative	1
overlykkelig	positive	1
overbelastning	negative	1
overbetalt	negative	1
overmanne	negative	1
overveldende	negative	1
overpriset	negative	1
tilsyn	negative	1
velte	negative	1
velte	negative	1
overvelde	negative	1
overveldet	negative	1
overveldende	positive	1
på grunn av	negative	1
på grunn av	positive	0
eierskap	positive	1
oksidasjons	negative	1
Stillehavs	positive	1
pute	positive	1
polstring	positive	1
padle	positive	1
smerte	negative	1
smerte	negative	1
smertefull	negative	1
smertefullt	negative	1
smerter	negative	1
velsmakende	positive	1
palliativ	positive	1
parese	negative	1
skjemme bort	negative	0
skjem bort	positive	0
universalmiddel 0
universalmiddel	positive	1
panache	positive	1
pandemi	negative	1
pang	negative	1
panikk	negative	1
panier	positive	1
pantomime-	positive	0
pap-	positive	0
paprika	positive	1
papyrus-	positive	0
parade	negative	1
parade	positive	1
paragon	positive	1
lammelse	negative	1
lammet	negative	1
overordnet	positive	1
paranoia	negative	1
utstyr som er	positive	0
omskriv	negative	1
omskriv	positive	1
parasitt	negative	1
parasollegativ 0
tilgi	positive	1
parer	negative	1
parietal	positive	1
papegøye	negative	1
parsimonious	negative	1
delta	positive	1
deltakelse	positive	1
partisan	negative	1
partner	positive	1
partnerskap	positive	1
passere	negative	1
lidenskapelig	positive	1
lidenskapelig	positive	1
passiv	negative	1
passivitet	negative	1
lim inn	negative	0
lim inn	positive	0
tidsfordriv	positive	1
pastor	positive	1
bakverk	positive	1
beite	positive	1
lapp	negative	1
patent	positive	1
patetisk	negative	1
tålmodighet	positive	1
pasient	positive	1
patriarkalsk	positive	1
beskytter	positive	1
patronage	positive	1
nedlatende	negative	1
mønster	negative	1
mangel	negative	1
fattig	negative	1
bonde	negative	1
betal	positive	1
tilbakebetaling	negative	1
betalings	negative	1
freds	positive	1
fredelig	positive	1
fredelig	positive	1
påfugl	positive	1
hakke	positive	1
særegenheter	negative	1
særegenhet	positive	1
fotgjenger	negative	1
stamtavle	positive	1
peer-	negative	0
uforlignelig	positive	1
straffens	negative	1
straffe	negative	1
bot bo	positive	0
forkjærlig	positive	1
venter på	positive	0
trenge inn i	negative	0
trenge gjennom	positive	0
penetrasjon	negative	1
kriminell	negative	1
nest siste	negative	0
nest siste	positive	0
oppfatter	positive	1
merkbar	positive	1
fortapelse	negative	1
flerårig	positive	1
perfekt	positive	1
perfeksjon	positive	1
fare	negative	1
farlig	negative	1
omkomme	negative	1
forgjengelig	negative	1
omkommet	negative	1
omkom	negative	1
skaden	negative	1
falsk skade 0
ekstra fordel 0
ekstra fordel 1
tillatelse	positive	1
skadelig	negative	1
gjerningsmann	negative	1
forevigelse	negative	1
evighet	positive	1
forvirret	negative	1
forvirring	negative	1
forfølge	negative	1
forfølgelses	negative	1
holde ut	negative	0
holde ut	positive	0
vedvarende	positive	1
vedvarende	positive	1
personable	positive	1
svette negativ0
relevant	positive	1
forstyrrelse	negative	1
kikhoste	negative	1
pervers	negative	1
perversjon	negative	1
pervers	negative	1
pervertert	negative	1
pessimisme	negative	1
pessimistisk	negative	1
skadedyrs	negative	1
pestilens	negative	1
kjæledyr	negative	1
petroleum	negative	1
petroleums	positive	1
smålig	negative	1
benk ​​	negative	0
fantom	negative	1
farmasøytisk	positive	1
filantrop	positive	1
filantropi	positive	1
filosof	positive	1
slim	negative	1
phoenix	positive	1
fonetisk	positive	1
falsk	negative	1
lege	positive	1
fysikk	positive	1
fysiologisk	positive	1
kroppslig	positive	1
piazza-	positive	0
velg	positive	1
picket	negative	1
picketing	negative	1
syltetøy	negative	1
piknik	positive	1
pittoresk	positive	1
fromhet	positive	1
gris	negative	1
due	negative	1
hauger	negative	1
pille	positive	1
plynder	negative	1
pute	positive	1
pilot	positive	1
hallik	negative	1
kvise	negative	1
furu	negative	1
tannhjul	negative	1
topp	positive	1
banebrytende	positive	1
from from	negative	0
fromme	positive	1
pirre	negative	1
piratkopiering	negative	1
pirat	negative	1
pistol	negative	1
grop sositive 0
fallgruve	negative	1
med	positive	1
svinge	positive	1
placebo-	negative	0
placebo-	positive	0
rolig	positive	1
plagiering	negative	1
pest	negative	1
saksøker	negative	1
planlegging	positive	1
belagt	negative	1
spiller	negative	1
leken	positive	1
lekeplass	positive	1
lekehus	positive	1
ankende	negative	1
hyggelig	positive	1
fornøyd	positive	1
behagelig	positive	1
løfte	positive	1
plenum	positive	1
rikelig	positive	1
pleksus	positive	1
dårlig	negative	1
dårlig posisjon 0
plodding	negative	1
plomme	positive	1
lodd	positive	1
stupte	negative	1
plyndre	negative	1
stup	negative	1
plysj	positive	1
lag	positive	1
lungebetennelse	negative	1
poaching	negative	1
poengtert	positive	1
meningsløs	negative	1
gift	negative	1
forgiftet	negative	1
forgiftning	negative	1
giftig	negative	1
poke	negative	1
polemisk	negative	1
politiets	positive	1
politimann	positive	1
polio	negative	1
polerings	positive	1
polert	positive	1
høflig	positive	1
høflighet	positive	1
politisk	positive	1
forurense	negative	1
forurensnings	negative	1
polo-	negative	0
polygami	negative	1
pomp	negative	1
pompøs	negative	1
tungtliggende	negative	1
påve positiv
basseng	positive	1
dårlig	negative	1
pop	negative	1
pave	positive	1
valmue-	negative	0
popularitet	positive	1
popularisert	positive	1
populasjons	positive	1
piggsvin	negative	1
porno	negative	1
porno	negative	1
pornografisk	negative	1
pornografi	negative	1
bærbar	positive	1
utgjør	negative	1
har	positive	1
besatt	negative	1
besittelse	negative	1
posthumt	negative	1
utsettelse	negative	1
drikke	positive	1
potensiell	positive	1
pund	negative	1
fattigdoms	negative	1
kraftig	positive	1
kraftig	positive	1
maktesløs	negative	1
praktisk mulig 0
praktisk talt	negative	0
praktisk talt 0
trene	positive	1
praktisert	positive	1
trene	positive	1
ros	positive	1
hyllet	positive	1
prisverdig	positive	1
prank	negative	1
be	positive	1
usikre	negative	1
forholdsregel	positive	1
føre var	positive	0
gå foran	negative	0
gå foran	positive	1
forrang	positive	1
distrikts	negative	1
dyrebar	positive	1
presis	positive	1
presisjons	positive	1
for tidlig	negative	0
for tidlig	positive	0
rov	negative	1
knipe	negative	1
predikatposisjon 0
forkjærlighet	positive	1
dominerende	positive	1
fremtredende	positive	1
foretrekker	positive	1
graviditet	negative	1
fordommer	negative	1
fordomsfull	negative	1
skadelig	negative	1
for tidlig	negative	0
for tidlig	positive	0
for tidlig	negative	0
for tidlig	positive	0
overlagt	negative	1
premier	positive	1
lokaler	positive	1
forbered deg	positive	1
forberedt	positive	1
forutgående	positive	1
reseptbelagt 0
tilstedeværelse	positive	1
nåværende	positive	1
presentabel	positive	1
presentasjon	negative	1
presentasjon	positive	1
konserveringsmiddel	positive	1
bevare	positive	1
president	positive	1
trykk	negative	1
prestisje	positive	1
presto	positive	1
formodent	negative	1
late som	negative	1
late som	positive	0
later som	negative	1
late som	positive	0
later som	negative	1
late som	positive	0
late	negative	1
pretensjoner	negative	1
ganske	positive	1
seire	positive	1
forebygging	positive	1
forebyggende	negative	1
bytte	negative	1
uvurderlig	positive	1
stikk	negative	1
stikkende	negative	1
stolthet	positive	1
preste	positive	1
prestedømmets	positive	1
preste	positive	1
forrangs	positive	1
primær	positive	1
primær	positive	1
primer	positive	1
ur-	negative	0
ur-	positive	0
prins	positive	1
fyrstelig	positive	1
prinsesse	positive	1
hoved	positive	1
skriv ut	positive	0
fengsels	negative	1
fange	negative	1
uberørt	positive	1
privilegert	positive	1
privy	negative	1
sannsynlighets	positive	1
problem	negative	1
prosedyre	positive	1
prosesjon	positive	1
utsette	negative	1
utsettelse	negative	1
proktor	positive	1
anskaffe	positive	1
fortapt	negative	1
fortapte	positive	1
fantastisk	positive	1
vidunderbarn 1
produsent	positive	1
produserer	positive	1
produksjon	positive	1
produktiv	positive	1
produktivitets	positive	1
profan	negative	1
banning	negative	1
bekjenne seg	negative	0
bekjenne seg	positive	0
yrkes	positive	1
profesjonell	positive	1
professor	positive	1
ferdighets	positive	1
dyktig	positive	1
rikelig	positive	1
overflod	negative	1
fremgang	positive	1
progresjon	positive	1
progressiv	positive	1
forbudt	negative	1
forbud	negative	1
produktiv	positive	1
forleng	negative	1
fremtredende	positive	1
fremtredende	positive	1
promiskuøs	negative	1
lover	positive	1
lovende	positive	1
promotering	positive	1
prop	positive	1
propaganda	negative	1
skikkelig	positive	1
profet	positive	1
profylaktisk	positive	1
proposisjon	positive	1
fremdriftsposisjon 0
forfølge	negative	1
straffeforfølge 0
påtale	negative	1
potensielt	positive	1
blomstre	positive	1
velstands	positive	1
velstående	positive	1
prostituert	negative	1
prostitusjons	negative	1
beskytt	positive	1
beskytte	positive	1
beskyttende	positive	1
beskytter	positive	1
stikker ut	negative	0
stikker ut	positive	0
stolt	positive	1
vise seg å være	positive	1
ordspråklig	positive	1
gi	positive	1
gir	positive	1
provokasjon	negative	1
provoserende	negative	1
forsiktig	positive	1
forsvarlig	positive	1
lirke	negative	1
nysgjerrig	negative	1
salme	positive	1
pseudo-	negative	0
psykose	negative	1
offentlig	positive	1
publicist	negative	1
publisere er	positive	0
oppblåst	negative	1
trekk	positive	1
talerstol	positive	1
punch	negative	1
punktlig	positive	1
punktlighet	positive	1
punkteringsposisjon 0
skarp	negative	1
straffe	negative	1
straffet	negative	1
straffe	negative	1
straff	negative	1
straffende	negative	1
dårlig poeng 0
valpe	positive	1
puré	negative	0
puré	positive	0
rent	positive	1
skjærsilden	negative	1
rens	negative	1
rensing	positive	1
rense	positive	1
puristisk	positive	1
renhets	positive	1
purr	positive	1
pus	negative	1
kvakks	negative	1
hengemyr	negative	1
vaktel	negative	1
eiendommelig	positive	1
kvalifisert	positive	1
kvalifiserende	positive	1
vanskelighets	negative	1
kvante-	negative	0
krangel	negative	1
quash	negative	1
stille	negative	1
søken	positive	1
spørsmål	positive	1
tvilsom	negative	1
hurtighet	positive	1
kvikksølv	negative	1
stille	positive	1
stille	positive	1
dynetilstand 0
kinin	positive	1
slutte	negative	1
kogger	negative	1
sitrende	negative	1
quiz	negative	1
beslutningsdyktig 0
sitat	negative	1
sitat	positive	1
rabble	negative	1
rabiat	negative	1
rabies	negative	1
rack	negative	1
racket	negative	1
utstrålings	positive	1
strålende	positive	1
utstråle	positive	1
strålings	negative	1
radio	positive	1
radioaktivt	negative	1
røntgenposisjon 0
radon	negative	1
tombolagetegativ 0
raseri	negative	1
rasende	negative	1
filler	negative	1
raid	negative	1
skinne	negative	1
ram	negative	1
vandrende	negative	1
rampage	negative	1
harsk	negative	1
løsepenger	negative	1
voldtekts	negative	1
rapt	positive	1
rovfugler	negative	1
henrykkelse	positive	1
rascal	negative	1
utslett	negative	1
rotte	negative	1
vurdering	negative	1
rasjonell	positive	1
raus	negative	1
rave	negative	1
rave	positive	1
glupsk	negative	1
raving	negative	1
barberhøvel positiv
reaksjonær	negative	1
leser	positive	1
lett	positive	1
beredskap	positive	1
lese	positive	1
bekreft	positive	1
virkelig	positive	1
vises igjen	negative	0
vises igjen	positive	0
bakre	negative	1
Årsaken	positive	1
sett sammen	negative	0
beroligende	positive	1
berolige	positive	1
rabatt	positive	1
opprør	negative	1
irettesette	negative	1
tilbakevise	negative	1
motstridende	negative	1
omarbeidet	positive	1
trekke seg	negative	0
trekke seg tilbake 0
mottatt	positive	1
mottar	positive	1
lavkonjunktur	negative	1
recherche	positive	1
tilbakevendende	negative	1
gjengjeld	positive	1
hensynsløs	negative	1
hensynsløshet	negative	1
tilbakelent	positive	1
gjenkjennelig	positive	1
anbefaler	positive	1
forsoning	positive	1
ny vurdering	positive	1
rekonstruere	positive	1
rekonstruksjon	positive	1
opptaker	positive	1
telle om	positive	0
få tilbake	negative	0
få tilbake	positive	1
utvinning	positive	1
rekreasjon	positive	1
rekreasjons	positive	1
rette opp	positive	1
innløsning	positive	1
oppreisning	positive	1
overflødig	negative	1
avgrense	positive	1
raffinement	positive	1
tilbakeløps	negative	1
reform	positive	1
reformasjons	positive	1
reformator	positive	1
ildfast	negative	1
avstå positive
forfriskende	positive	1
pusse opp	negative	0
pusse opp	positive	1
avslag	negative	1
nekte	negative	1
nektet	negative	1
kongelig	positive	1
regent	positive	1
registrer deg	positive	0
regress	negative	1
gå tilbake	positive	0
regressivt	negative	1
regressiv	positive	1
angre	negative	1
beklagelig	negative	1
angret	negative	1
angrer	negative	1
regelmessighet	positive	1
reguler	positive	1
regulatorisk	negative	1
rehabilitere	positive	1
rehabilitering	positive	1
refundere	positive	1
rein	negative	1
forsterkning	positive	1
installer	negative	0 på nytt
installer	positive	0 på nytt
gjenopprette	positive	1
tilbakestillingsposisjon 0
avvis	negative	1
avvist	negative	1
avvisning	negative	1
avviser	negative	1
glede seg over	negative	0
glede seg	positive	1
glede seg	negative	0
glede seg	positive	1
bli med	negative	0
bli med på	positive	0
forynge	positive	1
forynget	positive	1
gjenopplive	negative	1
gjenopplive	positive	1
tilbakefall	negative	1
avslapning	positive	1
relé	negative	0
relé	positive	0
nedrykk	negative	1
relevant	positive	1
pålitelighet	positive	1
pålitelig	positive	1
avhengighets	positive	1
lettelse	positive	1
lindre	positive	1
avstå	negative	1
glede seg over	negative	0
glede seg over	positive	0
motvillig	negative	1
forblir	negative	1
forblir	positive	1
nyinnspilling	positive	1
varetekts	negative	1
bemerkelsesverdig	positive	1
bemerkelsesverdig	positive	1
avhjelpende	negative	1
rette	positive	1
remiss	negative	1
remisjon	positive	1
pengeoverføring 0
ombygg	positive	1
anger	negative	1
fjerning	negative	1
fjern	negative	1
renessanse	positive	1
renkontre	negative	1
gjengi	negative	1
gjengi	positive	1
gjengivelse av	positive	0
frafalle	negative	1
gi avkall på	negative	1
gi avkall på	positive	0
renover	positive	1
renovering	positive	1
kjent kjent 1
kjent	positive	1
avkall	negative	1
omorganisere	positive	1
erstatning	positive	1
tilbakebetale	positive	1
gjentatte ganger	negative	0
gjentatte ganger	positive	0
avstøtende middel 1
frastøtende	negative	1
frastøter	negative	1
omvende deg	negative	0
angrer	positive	1
fyll på	negative	0
etterfyll	positive	1
fylt	positive	1
reporter	positive	1
hvile	positive	1
representert	positive	1
undertrykke	negative	1
undertrykkelse	negative	1
irettesette	negative	1
omtrykk	negative	1
represal	negative	1
bebreide	negative	1
reproduktiv	positive	1
reptil negativt
republikk	negative	1
avvisning	negative	1
frastøtnings	negative	1
hederlig	positive	1
oppheve	negative	1
opphevelse	negative	1
rednings	positive	1
motstå	negative	1
irriterende	negative	1
harme	negative	1
reserve	positive	1
boliger	positive	e 0
beboer	positive	1
fratre	negative	1
si opp	positive	0
fratredelse	negative	1
sa opp	negative	1
sa opp	positive	0
elastisk	positive	1
motstå	negative	1
motstand	negative	1
motstandsdyktig	negative	1
motstå	negative	1
resistiv	positive	1
resolutt	positive	1
ressurser	positive	1
respekter	positive	1
respektabilitet	positive	1
respektabel	positive	1
respektfull	positive	1
respekterer	positive	1
respekterer	positive	1
frist	positive	1
strålende	positive	1
ansvarlig	positive	1
responsiv	positive	1
hvile	positive	1
avslappende	positive	1
restitusjons	positive	1
gjenopprettende	positive	1
gjenopprette	positive	1
begrense	negative	1
tilbakeholdenhet	positive	1
begrense	negative	1
begrensning	negative	1
begrensende	negative	1
gjenopptakelse	positive	1
ta på nytt	positive	0
gjengjelde	negative	1
gjengjeldelse	negative	1
gjengjeldelses	negative	1
gjengjeldelsesposisjon 0
forsinke	negative	1
retardasjon	negative	1
retensjons	positive	1
tilbakeholdende	negative	1
pensjons	negative	1
pensjonist	positive	1
trekker seg	negative	0
retort	negative	1
trekke	negative	1
trekke tilbake	positive	0
tilbaketrekning	negative	1
nedleggelse	negative	1
gjengjeldelse	negative	1
tilbakevirkende kraft 0
retrograd	negative	1
gjensyn	positive	1
glede seg	positive	1
gleder seg	positive	1
hevn	negative	1
ærbødig	positive	1
ærbødig	positive	1
ærbødig	positive	1
ærbødig	positive	1
reversering	negative	1
revidere	positive	1
gå tilbake	positive	0
vekkelse	positive	1
gjenopplive	negative	1
gjenopplive	positive	1
tilbakekalling	negative	1
tilbakekalle	negative	1
opprør	negative	1
opprørende	negative	1
revolusjons	negative	1
revolusjons	positive	1
revolusjonerende	positive	1
revolver	negative	1
avsky	negative	1
belønning	positive	1
revmatisme	negative	1
rytme	positive	1
rytmisk	positive	1
bånd	positive	1
rikdom	positive	1
vaklende	negative	1
riddled	negative	1
rytter	positive	1
latterliggjøre	negative	1
latterlig	negative	1
flor	negative	1
rifle	negative	1
rift	negative	1
rettferdig	positive	1
rettmessig	positive	1
riktig	positive	1
stiv	negative	1
stivhet	negative	1
streng	negative	1
streng	negative	1
ringetone	negative	1
opprørs	negative	1
opprørske	negative	1
moden	positive	1
modnes	positive	1
stigende	positive	1
risiko	negative	1
risikabelt	negative	1
rivalisering	negative	1
naglende	positive	1
roadster-	positive	1
rane	negative	1
røver	negative	1
ran	negative	1
robust	positive	1
stein	positive	1
stang	positive	1
skurk	negative	1
rollicking	positive	1
romantikk	positive	1
romantisk	positive	1
romantikk	positive	1
boltre	positive	1
røyk	negative	1
forankret	positive	1
listeposisjon 0
rosenrød	positive	1
rot	negative	1
rota	positive	1
råtnende	negative	1
ruhet	negative	1
roul ette	positive	0
rout	negative	1
rutine	positive	1
rad	negative	1
bølle	negative	1
royalty	positive	1
søppel	negative	1
murstein	negative	1
rubrikkposisjon 1
rue	negative	1
ruffle	negative	1
robust	negative	1
ødelegge	negative	1
ødelagt	negative	1
ødeleggende	negative	1
rykte	negative	1
runaway	negative	1
brudd	negative	1
ruse	negative	1
rust	negative	1
rusten	negative	1
ruth	positive	1
hensynsløs	negative	1
sabel	negative	1
sabotasje	negative	1
ofrer	negative	1
dessverre	negative	1
tristhet	negative	1
trygt	positive	1
beskytte	positive	1
oppbevaringsposisjon 0
sag	negative	1
salvie	positive	1
helgen	positive	1
saintly	positive	1
lønns	positive	1
fremtredende	positive	1
saltoppløsning 0
helse	positive	1
hilsen	positive	1
frelse	positive	1
salve	positive	1
samurai	positive	1
helliggjørelse	positive	1
hellige	positive	1
helligdom	positive	1
sanguine	positive	1
sanitær	positive	1
sunn fornuft positiv
sap	negative	1
sarkasme	negative	1
sarkom	negative	1
sardonisk	negative	1
satanisk	negative	1
sateng	positive	1
tilfredsstillende	positive	1
fornøyd	positive	1
mettet	negative	1
vill	negative	1
villskap	negative	1
lagre	positive	1
besparelser	positive	1
nyte	positive	1
velsmakende	positive	1
smart	positive	1
scab	negative	1
stillas	negative	1
skalpell	negative	1
skjellende	negative	1
skandale	negative	1
skandaløst	negative	1
sparsomt	negative	1
syndebukk	negative	1
arr	negative	1
scarab-	positive	0
knappe	negative	1
knapt	negative	1
knapphet	negative	1
skremme	negative	1
fugleskremsel	negative	1
fugleskremsel	positive	1
scavenger	negative	1
ordning	negative	1
splittelse	negative	1
schizofreni	negative	1
lærer	positive	1
stipend	positive	1
isjias	negative	1
vitenskapelig	positive	1
forsker	positive	1
scintilla	positive	1
spott	negative	1
skjelle	negative	1
skjennende	negative	1
brennende	negative	1
score	positive	1
forakt	negative	1
skorpion	negative	1
skotsk	negative	1
skurk	negative	1
svøpe	negative	1
kryptering	negative	1
skrapie	negative	1
skrik	negative	1
skrikende	negative	1
skrik	negative	1
skrudd	negative	1
skriftlig	positive	1
scrimmage	negative	1
skript	positive	1
skrubb	negative	1
deilig	positive	1
nøye 0
granske	negative	1
granskning	negative	1
skulptur	positive	1
avskum	negative	1
sjø	positive	1
tetnings	positive	1
sear	negative	1
krydret	positive	1
løsrivelse	negative	1
bortgjemt	negative	1
isolasjon	negative	1
tilbaketrukkethet 1
brukt	negative	1
sekresjon	negative	1
hemmelighetsfull	negative	1
sekterisk	negative	1
sedisjon	negative	1
forføre	negative	1
forførelse	negative	1
segreger	negative	1
segregerte	negative	1
grip	negative	1
egoistisk	negative	1
egoisme	negative	1
senil	negative	1
ansiennitet	positive	1
oppsiktsvekkende	positive	1
fornuftig	positive	1
meningsløs	negative	1
følsomhets	positive	1
fornuftig	positive	1
sensuell	negative	1
sensuell	positive	1
sensualitet	positive	1
sanselig	positive	1
setning	negative	1
sentimental	positive	1
sentimentalitet	positive	1
sentinel	positive	1
separatistisk	negative	1
sepsis	negative	1
septisk	negative	1
bundet	negative	1
rolig	negative	1
stillhet	positive	1
alvor alvorlig 0
forkynnelse	positive	1
slangens	negative	1
serum	positive	1
tjener	negative	1
server	negative	1
servile	negative	1
slaveri	negative	1
tilbakeslag	negative	1
settlor-	negative	0
settlor	positive	1
alvorlig	negative	1
fratredelsesposisjon 0
kloakk	negative	1
avløps	negative	1
sex	positive	1
loslitt	negative	1
hytte	negative	1
sjakel	negative	1
skygge-	negative	0
lyssky	negative	1
risting	negative	1
rystende	negative	1
skam	negative	1
knuser	negative	1
skam	negative	1
skammelig	negative	1
skamløs	negative	1
Shanghai	negative	1
form	positive	1
velskapt	positive	1
del	positive	1
haie	negative	1
knuse	negative	1
knust	negative	1
kaste	negative	1
skall	negative	1
ly	positive	1
hyllet	negative	1
gjeter	positive	1
skiftposisjon 0
skinne	positive	1
skinnende	positive	1
forlis	negative	1
dritt	negative	1
skjelve	negative	1
støt	negative	1
skummel	negative	1
skyte	negative	1
skytespill 0
skyting	negative	1
butikktyveri	negative	1
handle	positive	1
mangel	negative	1
mangel	negative	1
skutt	negative	1
skulder	positive	1
skyv	negative	1
prangende	negative	1
kløktig	positive	1
skrik	negative	1
skingrende	negative	1
krympe	negative	1
trekk på	negative	0
trekke på	positive	0
krympet	negative	1
gyser	negative	1
unngå	negative	1
syk	negative	1
kvalmende	negative	1
sykelig	negative	1
sykdoms	negative	1
silke	positive	1
dumt	negative	1
forenkle	positive	1
ganske enkelt	negative	0
ganske enkelt	positive	0
synd	negative	1
oppriktig	positive	1
oppriktig	positive	1
syndig	negative	1
syng	positive	1
enkeltvis	positive	1
uhyggelig	negative	1
synder	negative	1
syndende	negative	1
sir	positive	1
sirene	negative	1
nissende	negative	1
søsterskap	positive	1
skeptisk	negative	1
sketchy	negative	1
skjev	negative	1
glidende	negative	1
dyktighet sositive 0
dyktige	positive	1
dyktig	positive	1
hopp over	negative	1
hopp over	positive	0
trefning	negative	1
himmel	positive	1
slapp	negative	1
slagg	negative	1
smelle	negative	1
baktaler	negative	1
baktalende	negative	1
slå	negative	1
skifer	positive	1
slakt	negative	1
slakteri	negative	1
slakting	negative	1
slave	negative	1
slaveri	negative	1
drepe	negative	1
slayer	negative	1
slank	positive	1
sludd	negative	1
slank	positive	1
slank	positive	1
slimete	negative	1
slink	negative	1
glidende	negative	1
slop	negative	1
slurvet	negative	1
dovendyr	negative	1
slapp	negative	1
svak	negative	1
treghet	negative	1
slam	negative	1
slug	negative	1
svak	negative	1
slum	negative	1
nedgang	negative	1
slur	negative	1
slush	negative	1
ludder	negative	1
slu	negative	1
smack	negative	1
liten	negative	1
knuse	negative	1
knust	negative	1
smatterende	negative	1
lukt	negative	1
lukter	negative	1
smile	positive	1
smiler	positive	1
smirk	negative	1
slå	negative	1
slått	positive	1
røyker	negative	1
glatt	positive	1
kvele	negative	1
flekk	negative	1
selvtilfreds	negative	1
smugle	negative	1
smugler	negative	1
smugling	negative	1
smut	negative	1
hake	negative	1
haker	negative	1
slange	negative	1
snare	negative	1
snarl	negative	1
knurrende	negative	1
snike	negative	1
snikende	negative	1
hån	negative	1
nys	negative	1
snicker	positive	1
glide	negative	1
snobb	negative	1
suge	negative	1
sob	negative	1
nøkternhet 1
omgjengelig	positive	1
sosialistisk	negative	1
jord	negative	1
skitten	negative	1
trøst	positive	1
sol-	positive	0
loddetegativt 0
soldat	positive	1
ber om	positive	0
solid	positive	1
soliditet	positive	1
løsning	positive	1
soliditet 1
somatisk	negative	1
dyster	negative	1
ekkoloddposisjon 1
sonate	positive	1
sonett	positive	1
sonorøs	positive	1
sot	negative	1
berolige	positive	1
beroligende	positive	1
trolldom	negative	1
sordid	negative	1
sår	negative	1
veldig	negative	1
ømhet	negative	1
sorg	negative	1
sorgfull	negative	1
sorterings	positive	1
sortie	negative	1
sjelløs	negative	1
sjelevennen din	negative	1
høres	negative	ut 0
høres	positive	ut 0
høres	negative	ut 0
høres	positive	ut 0
lydstyrke	positive	1
suppe	positive	1
surt	negative	1
spa-	negative	0
spa-	positive	1
romslige	positive	1
spaniel	positive	1
spank	negative	1
glitrende	positive	1
krampe	negative	1
spyttet	negative	1
spyd	negative	1
spesiell	positive	1
spesie	positive	1
flekk	negative	1
brille	negative	1
brille	positive	1
spøkelses	negative	1
spøkelsesposisjon 0
spektral	negative	1
spekulasjon	negative	1
tale	positive	1
rask	positive	1
stavemåte 1
brukt	negative	1
krydder	positive	1
edderkopp positiv
ryggrad	negative	1
ryggrads	positive	1
spinster	negative	1
åndelig	positive	1
brennevin	positive	1
til tross for	negative	1
til tross for	positive	0
ondskapsfull	negative	1
fantastisk	positive	1
prakt	positive	1
splint	negative	1
splitt	negative	1
splitte	negative	1
ødelegge	negative	1
spoiler	negative	1
snakket	negative	1
svamp	negative	1
sponsor	positive	1
spook	negative	1
plettfrie	positive	1
ektefelle	positive	1
forstuing	negative	1
spree	negative	1
sprite	negative	1
gran	positive	1
falske	negative	1
squall	negative	1
knebøy	negative	1
squeamish	negative	1
squelch	negative	1
vri	negative	1
stikke	negative	1
stabil	positive	1
staccato	positive	1
personalet er	positive	0
trinnposisjon 0
svimlende	negative	1
stillestående	negative	1
flekk	negative	1
rustfritt	positive	1
trappegang 0
foreldet	negative	1
stilk	negative	1
hingst	positive	1
stødig	positive	1
utholdenhets	positive	1
står	positive	1
avstand	negative	1
stillstand	negative	1
stjerne	positive	1
stirrer	negative	1
sterkt	negative	1
stjernelys	positive	1
stjerneklar	positive	1
skremmende	negative	1
sult	negative	1
sultet	negative	1
sultende	negative	1
staselig	positive	1
uttalelse	positive	1
kupéposisjon 0
stasjonær	negative	1
statue	positive	1
status	positive	1
trofast	positive	1
stav	negative	1
hold deg	negative	0
hold deg	positive	0
holdt seg	negative	0
holdt seg	positive	0
standhaftig	positive	1
stjele	negative	1
stjele	negative	1
snikende	negative	1
fantastisk	positive	1
stereotype	negative	1
stereotyp	negative	1
sterilt	negative	1
sterilitets	negative	1
sterling	negative	1
sterling	positive	1
streng	negative	1
forvalter	positive	1
hold deg	positive	0
stiv	negative	1
stivhet	negative	1
kvale	negative	1
kvalt	negative	1
stigma	negative	1
dødfødt	negative	1
stillhet	positive	1
sviende	negative	1
sviende	negative	1
gjerrig	negative	1
stink	negative	1
stinkende	negative	1
stint	negative	1
aksjer	negative	1
stjålet	negative	1
stein	negative	1
steinet	negative	1
avføring	negative	1
stopp	negative	1
lagre	positive	1
lagring av	positive	0
storm	negative	1
stormfullt	negative	1
oppbevaringsposisjon 0
grei	positive	1
anstrengt	negative	1
sund	negative	1
strandet	negative	1
fremmed	negative	1
kvele	negative	1
strategisk	positive	1
strateg	positive	1
avvikende	negative	1
styrke	positive	1
styrke	positive	1
styrke	positive	1
stress	negative	1
strid	negative	1
slå	negative	1
slående	positive	1
slående	positive	1
strip	negative	1
stripe	negative	1
strippet	negative	1
hjerneslag	negative	1
sterkt	positive	1
struktur	positive	1
sliter	negative	1
stiv	negative	1
stud	positive	1
studer	positive	1
tett	negative	1
snuble	negative	1
bedøvet	negative	1
stuntposisjon 0
stunt	negative	1
dumt	negative	1
dumhet	negative	1
dumt	negative	1
solid	positive	1
sty	negative	1
subkutan eous	positive	0
del opp	negative	0
del inn	positive	0
undertrykke	negative	1
emnet	negative	1
utsatt	negative	1
underkastelse	negative	1
underkastelse	negative	1
sublimering	positive	1
send inn	negative	0
send inn	positive	0
underordnet	negative	1
stevning	negative	1
nedsenking	negative	1
tilskudds	negative	1
bestå	negative	1
stoff	positive	1
substansiell	positive	1
trekk	negative	1
subversjon	negative	1
subversivt	negative	1
undergrave	negative	1
t-bane	negative	0
t-bane	positive	0
lykkes	positive	1
lykkes	positive	1
suksess	positive	1
vellykket	positive	1
kortfattet	positive	1
saftig	negative	1
saftig	positive	1
bukke under 1
bukke under 0
suge	negative	1
suger	negative	1
saksøke	negative	1
lider	negative	1
lidende	negative	1
lider	negative	1
tilstrekkelig	positive	1
kvelende	negative	1
kvelnings	negative	1
sukker	positive	1
selvmords	negative	1
selvmords	negative	1
passende	positive	1
mutt	negative	1
sultry	positive	1
innkalling	negative	1
sol	positive	1
senket	negative	1
solrik	positive	1
soleret	positive	1
solskinns	positive	1
ypperlig	positive	1
overfladisk	negative	1
overflødig	negative	1
overmenneskelig	positive	1
overlegen	positive	1
overlegenhet	positive	1
supermann	positive	1
superstjerne	positive	1
overtro	negative	1
overtro	positive	1
overtroisk	negative	1
bønn	positive	1
leverer	positive	1
levere	positive	1
støttet	positive	1
supporter	positive	1
støtte	positive	1
undertrykke	negative	1
undertrykkelse	negative	1
overlegenhet	negative	1
overlegenhet	positive	1
høyeste	positive	1
svært	positive	1
tilleggsavgift	negative	1
kausjons	positive	1
surly	negative	1
anta	positive	1
overgår	positive	1
overraskelses	positive	1
overgi	negative	1
overgi	negative	1
surround	negative	1
surround	positive	1
oppmåling	positive	1
overleve	positive	1
mottakelig	negative	1
mistenkt	negative	1
suspensjon	negative	1
mistanke	negative	1
mistenkelig	negative	1
vattpinne	negative	1
sump	negative	1
sumpete	negative	1
svane-	negative	0
hakekors	negative	1
sverger	positive	1
søt	positive	1
kjæreste	positive	1
kjære	positive	1
sødme	positive	1
søtsaker	positive	1
hovne opp	negative	0
hovne opp	positive	0
hevelse	negative	1
raskt	positive	1
sving	negative	1
svøm	positive	1
svin	negative	1
hovent	negative	1
symbolsk	positive	1
symmetrisk	positive	1
symmetri	positive	1
sympatisk	positive	1
sympati	positive	1
symfoni	positive	1
symptom	negative	1
synkroniser	positive	1
synkope	negative	1
synergistisk	positive	1
synode	positive	1
synonymt	negative	1
synonymt	positive	1
tabu	negative	1
takt	positive	1
farget	negative	1
fortelling	positive	1
talent	positive	1
talisman	positive	1
snakk	positive	1
klør	negative	1
sammenfiltret	negative	1
garvet	positive	1
pirrende	negative	1
pirrende	positive	1
forsinkelse	negative	1
treg	negative	1
takst	negative	1
sverte	negative	1
tarry	negative	1
oppgave	positive	1
smakfull	positive	1
smakløst	negative	1
velsmakende	positive	1
hån	negative	1
skattemessig 1
skatteposisjon ive 0
taxicab-	positive	0
undervis	positive	1
lærer	positive	1
erte	negative	1
ertende	negative	1
teknologi	positive	1
kjedelig	negative	1
tedium	negative	1
tenåringer	negative	1
tenåringer	positive	1
TV-	negative	0
TV-	positive	0
tempera-	negative	0
temperament	positive	1
herdet	positive	1
storm	negative	1
fristelse	negative	1
holdbar	positive	1
seig	positive	1
utholdenhet	positive	1
leieforhold	positive	1
leietaker	positive	1
ømt	positive	1
ømhet	positive	1
leie	negative	1
ti ganger	positive	0
terminal	negative	1
oppsigelse	negative	1
termitt	negative	1
forferdelig	negative	1
terror	negative	1
terrorisme	negative	1
terrorist	negative	1
terrorisere	negative	1
stivkrampe	negative	1
tether	negative	1
takknemlig	positive	1
takksigelse	positive	1
tyveri	negative	1
teisme	negative	1
teokratisk	negative	1
teoremposisjon 0
teoretisk	positive	1
terapeutisk	positive	1
terapeutisk	positive	1
om lag	negative	0
om lag	positive	0
synonymordbok 0
tyv	negative	1
tenker	positive	1
tørst	negative	1
torn	negative	1
tornete	negative	1
fullblods	positive	1
gjennomtenkt	positive	1
omtenksomhet	positive	1
tankeløs	negative	1
thrash	negative	1
trussel	negative	1
truer	negative	1
truende	negative	1
trøske	negative	1
tre ganger	negative	0
tre ganger	positive	0
sparsommelig	positive	1
spennende	positive	1
spennende	positive	1
blomstrende	positive	1
bankende	negative	1
trone	positive	1
gass ​​	negative	1
gass ​​	positive	0
kjeltring	negative	1
dunk	negative	1
tordnende	negative	1
hindre	negative	1
kile	positive	1
tidevannsposisjon 0
godbit 0
tiff	negative	1
flislegging	positive	1
styrestang negativ
rettidig	positive	1
ur negativ
redd	negative	1
redd	negative	1
glitter	positive	1
fargetone 0
tøff	negative	1
tirade	negative	1
sliten	negative	1
tretthet	negative	1
kjedelig	negative	1
tit	negative	1
tittel	positive	1
med tittelen	negative	0
med tittelen	positive	0
padde	negative	1
skål	positive	1
tobakk	negative	1
i dag	negative	0
i dag	positive	0
toalett	negative	1
slit	negative	1
tolerant	positive	1
tolererer	negative	1
toleranse	positive	1
i morgen	negative	0
i morgen	positive	0
tannpine	negative	1
topp	positive	1
pine	negative	1
revet	negative	1
torpedo	negative	1
voldsom	negative	1
skadevoldende	negative	1
torturistisk	negative	1
tortur	negative	1
rørt	negative	1
berørt	negative	1
tøff	negative	1
seighet	positive	1
tårn	positive	1
ruvende	positive	1
giftig	negative	1
toksin	negative	1
kan trekkes	positive	0
tradisjonell	positive	1
tragedie	negative	1
tragisk	negative	1
forræder	negative	1
tramp	negative	1
transe	negative	1
rolig	positive	1
ro	positive	1
transcendens	positive	1
transcendentalt	positive	1
overtredelse	negative	1
felle	negative	1
feller	negative	1
søppel	negative	1
søppel	negative	1
traumatisk	negative	1
travail	negative	1
reiser	positive	1
travesty	negative	1
forræderisk	negative	1
svik	negative	1
forræderi	negative	1
skatte	positive	1
behandle	negative	1
behandle	positive	1
treet	positive	1
skjelvende	negative	1
utrolig	positive	1
tremor	negative	1
trend	positive	1
trendy	positive	1
trepidation	negative	1
overskridelse	negative	1
trengsel	negative	1
nemnds	negative	1
sideelv	positive	1
hyllest	positive	1
triks	negative	1
lureri	negative	1
vanskelig vanskelig 0
bagatell	negative	1
trig	positive	1
tripping	negative	1
triumf	positive	1
triumferende	positive	1
troll	negative	1
trofé-	negative	0
trofee	positive	1
plagsom	negative	1
våpenhvile	positive	1
ekte	positive	1
trompet	negative	1
avkort positive
fagverksposisjon 0
pålitelig	positive	1
sannhets	positive	1
sannferdighet	positive	1
trommel	negative	1
svulst	negative	1
svulst	negative	1
tumult	negative	1
urolig	negative	1
turbulens	negative	1
turbulent	negative	1
uro	negative	1
veiledning	positive	1
veileder	positive	1
tvilling	positive	1
glimt	positive	1
rykk	negative	1
tyfon	negative	1
tyrannisk	negative	1
tyranni	negative	1
tyran	negative	1
stygg	negative	1
stygg	negative	1
magesår 1
baktil	negative	1
til slutt	negative	0
til slutt	positive	1
ultimatum	negative	1
dommer	positive	1
ute av stand	negative	1
ute av stand	positive	0
uakseptabelt	negative	1
unaccountable	negative	1
ikke godkjent	negative	0
ikke godkjent	positive	0
uten hjelp	positive	0
enstemmig	positive	1
enstemmig	positive	1
ikke godkjent	negative	1
ikke godkjent	positive	0
beskjeden	positive	1
løsrevet	negative	1
uoppnåelig	negative	1
lite attraktiv	negative	1
lite attraktiv 0
uautorisert	negative	1
uunngåelig	negative	1
uvitende	negative	1
uutholdelig	negative	1
ubeseiret	negative	1
ubeseiret	positive	1
vantro	negative	1
utrolig	negative	1
upartisk	positive	1
ufødt	negative	1
uknuselig	positive	1
uhemmet	negative	1
uhemmet	positive	1
ubrutt	positive	1
uhyggelig	negative	1
uforsiktig	negative	1
usikker	negative	1
uforanderlig	negative	1
urent	negative	1
ubehagelig	negative	1
ikke-tilkoblet	negative	0
ikke tilkoblet	positive	0
ubevisst	negative	1
bevisstløs	negative	1
grunnlovsstridig	negative	1
ubegrenset	positive	1
ukontrollerbar	negative	1
ukontrollert	negative	1
ubestemt	negative	1
ligger til grunn	negative	0
ligger til grunn for	positive	0
understreke	positive	1
undergravd	negative	1
underbetalt	negative	1
underdimensjonert	negative	1
forståelse av	positive	1
garanterer	positive	1
uønsket	negative	1
uønsket	negative	1
ikke-rettet	negative	0
ikke-rettet	positive	0
udelt	positive	1
angre	negative	1
kle av seg	negative	0
kle av seg	positive	0
udødelige	positive	1
uro	negative	1
urolig	negative	1
uutdannet	negative	1
arbeidsledige	negative	1
ulik	negative	1
utvetydig	positive	1
ujevn	negative	1
uventet	negative	1
uventet	positive	1
uforklarlig	negative	1
urettferdig	negative	1
urettferdighet	negative	1
utro	negative	1
ugunstig	negative	1
uferdig	negative	1
utfolde seg	negative	0
utfolde seg	positive	1
utilgivende	negative	1
uheldig	negative	1
uvennlig	negative	1
uoppfylt	negative	1
umøblert	negative	1
ugudelig	negative	1
utakknemlig	negative	1
ulykke	negative	1
ulykkelig	negative	1
usunne	negative	1
uhellig	negative	1
forening	positive	1
jevnt	positive	1
ufattelig	negative	1
ufattelig	positive	1
uviktig	negative	1
uimponert	negative	1
uforbedret	negative	1
uinfisert	positive	1
uinformert	negative	1
uinnviet	negative	1
uinspirert	negative	1
uforståelig	negative	1
utilsiktet	negative	1
uinteressert	negative	1
uinteressant	negative	1
unik	positive	1
unison	positive	1
enhetlig	positive	1
samlet	positive	1
enhet	positive	1
universitets	positive	1
urettferdig	negative	1
uforsvarlig	negative	1
uberettiget	negative	1
uvennlig	negative	1
ukjent	negative	1
ulovlig	negative	1
slipp løs	positive	0
ulisensiert	negative	1
i motsetning til	negative	0
i motsetning til	positive	0
ubegrenset	positive	1
låse opp	negative	0
låse opp	positive	0
uheldig	negative	1
uhåndterlig	negative	1
unaturlig	negative	1
lite påtrengende	positive	0
uoffisiell	negative	1
pakke ut	negative	0
pakke ut	positive	0
ulønnet	negative	1
ubehagelig	negative	1
upopulær	negative	1
uforutsigbar	negative	1
uforberedt	negative	1
upretensiøs	positive	1
uproduktiv	negative	1
ulønnsom	negative	1
ubeskyttet	negative	1
upublisert	negative	1
utvilsomt	positive	1
utvilsomt	positive	1
ubestridt	positive	1
ikke registrert	positive	0
ikke-relatert	negative	0
ikke-relatert	positive	0
upålitelig	negative	1
ubesvarte	negative	1
uregjerlig	negative	1
usikre	negative	1
utilfredsstillende	negative	1
misfornøyd	negative	1
usmakelig	negative	1
uskadd	positive	1
skruppelløs	negative	1
uselvisk	positive	1
urolig	negative	1
skjemmende	negative	1
usofistikert	negative	1
usigelig	negative	1
ustabil	negative	1
ustø positiv
mislykket	negative	1
uegnet	negative	1
usungt	negative	1
ikke-støttet	negative	1
ikke-støttet	positive	0
uovertruffen	positive	1
uholdbar	negative	1
usympatisk	negative	1
utemmet	negative	1
uholdbar	negative	1
utenkelig	negative	1
uryddig	negative	1
løsne	negative	1
løsne	positive	1
utidig	negative	1
uten tittel	negative	1
uten tittel	positive	0
utallige	negative	1
uheldig	negative	1
utrent	negative	1
ikke-oversatt	negative	0
ikke-oversatt	positive	0
usanne	negative	1
upålitelig	negative	1
uberettiget	negative	1
uvasket	negative	1
urokkelig	positive	1
uvelkomne	negative	1
dårlig	negative	1
uvillighet	negative	1
slapp av	negative	0
slapp av	positive	0
uklokt	negative	1
ubevisst	negative	1
uverdig	negative	1
usikker	negative	1
omveltning	negative	1
oppoverbakke	negative	1
oppoverbakke	positive	1
løft	positive	1
oppreist	positive	1
opprør	negative	1
oppstyr	negative	1
opprørt	negative	1
kråkebolle	negative	1
haster	negative	1
nytte	positive	1
unyttig	negative	1
innled	positive	1
vanlig	positive	1
usurp	negative	1
usurped	negative	1
rente	negative	1
nytte	positive	1
utopisk	positive	1
ledig	negative	1
ferie	positive	1
vaksine	positive	1
vakuum	negative	1
vag	negative	1
uklarhet	negative	1
forgjeves	negative	1
tapper	positive	1
tapper	positive	1
verdifullt	positive	1
vampyr	negative	1
forkant	positive	1
forsvunnet	negative	1
forfengelighet	negative	1
overvinne	positive	1
varicella	negative	1
varicose	negative	1
vegetativt	negative	1
heftig	negative	1
fløyel	positive	1
fløyelsaktig	positive	1
vendetta	negative	1
finér	negative	0
finér	positive	0
ærverdige	positive	1
ærbødig	positive	1
hevn	negative	1
hevngjerrig	negative	1
gift	negative	1
giftig	negative	1
sannhet	positive	1
grovhet	negative	1
grønn	positive	1
verge	negative	1
bekreftelse	positive	1
bekreftet	positive	1
virkelig	positive	1
virkelig	positive	1
skadedyr	negative	1
vernal	positive	1
kontra	negative	1
svimmelhet	negative	1
verve	positive	1
veteran	positive	1
vetoregativ 1
veto-	positive	0
vikar	positive	1
vice	negative	1
ondskapsfull	negative	1
offer	negative	1
utsatt	negative	1
victor	positive	1
seirende	positive	1
seiers	positive	1
årvåkenhet	positive	1
årvåken	positive	1
energi	positive	1
kraftig	positive	1
landsbyboer	positive	1
skurk	negative	1
skurk	negative	1
bekreftet	positive	1
rettferdiggjørelse	positive	1
hevngjerrig	negative	1
brudd	negative	1
volds	negative	1
voldelig	negative	1
voldsomt	negative	1
huggorm	negative	1
jomfru	positive	1
jomfru	positive	1
dyd	positive	1
dydig	positive	1
virulens	negative	1
virus	negative	1
syn	positive	1
visjonær	positive	1
besøk	positive	1
besøks	negative	1
besøkende	positive	1
vital	positive	1
vitalitets	positive	1
livlig	positive	1
levende	positive	1
vixen	negative	1
ordforråd	positive	1
volatilitet	negative	1
vulkan	negative	1
frivillig	positive	1
vellystig	positive	1
oppkast	negative	1
voodoo	negative	1
stemme	negative	1
stemme	positive	1
godtgjør	positive	1
løfte	positive	1
vulgært	negative	1
vulgaritet	negative	1
sårbarhet	negative	1
gribbe	negative	1
vaffel	negative	1
lønn	positive	1
klage	negative	1
vent	negative	1
velte seg	negative	1
wan	negative	1
avta	negative	1
ønsker	negative	1
krigs	negative	1
vakt	negative	1
ware	negative	1
krigføring	negative	1
krigslignende	negative	1
advare	negative	1
warp	negative	1
vridd	negative	1
garanti	positive	1
kriger	positive	1
vorte	negative	1
avfall	negative	1
bortkastet	negative	1
sløsende	negative	1
kaste bort	negative	1
kaste bort	positive	0
vakthund	positive	1
vaktsom	positive	1
vakt	positive	1
vanntett	positive	1
vannaktig	negative	1
vakle	negative	1
svekket	negative	1
svakt	negative	1
svakhet	negative	1
velstands	positive	1
slitasje	negative	1
sliten	negative	1
tretthet	negative	1
sliten	negative	1
værbestandig	positive	1
ugress	negative	1
gråte	negative	1
vekt	negative	1
vekt	positive	1
rare	negative	1
rare	negative	1
velkommen	positive	1
wen	negative	1
wench	negative	1
whack	negative	1
kai-	negative	0
hvor det er	positive	0
innfall	negative	1
sutre	negative	1
pisk	negative	1
virvelvind	negative	1
whisky	negative	1
hvit	positive	1
hvithet	positive	1
sunn	positive	1
hore	negative	1
ond	negative	1
ondskap	negative	1
wicket	positive	1
utbredt	positive	1
enke-	negative	0
vill	negative	1
villkatt	negative	1
bål	negative	1
forsettlig	negative	1
villig	positive	1
wimp	negative	1
wimpy	negative	1
bli	negative	1
uønsket	positive	1
vinner	positive	1
vinner	positive	1
gevinster	positive	1
trådløs	positive	1
er	positive	1
visdom	positive	1
klokt	positive	1
med	positive	1
hekse	negative	1
trolldom	negative	1
trekke ut	negative	1
trekke tilbake	positive	0
visne	negative	1
visnet	negative	1
tåle	positive	1
forstandig	positive	1
vittig	positive	1
veiviser	positive	1
ve	negative	1
uhyggelig	negative	1
sørgelig	negative	1
livmor	positive	1
fantastisk	positive	1
fantastisk	positive	1
vidunderlig	positive	1
vil ikke være	negative	0
ord	positive	1
ord	negative	1
fungerer	positive	1
orme	negative	1
slitt	negative	1
bekymret	negative	1
bekymrings	negative	1
bekymringsfull	negative	1
verre	negative	1
forverring	negative	1
tilbedelse	positive	1
verdt	positive	1
verdiløs	negative	1
verdig	positive	1
ikke	positive	1
sår	negative	1
kranglende	negative	1
vrede	negative	1
forårsake	negative	1
vrak	negative	1
ødelagt	negative	1
skiftenøkkel	negative	1
bryting	negative	1
elendig	negative	1
elendig	negative	1
forfatter	positive	1
feil	negative	1
urettmessig	negative	1
urettmessig	negative	1
feil	negative	1
smidd	negative	1
skikkelig	negative	1
fremmedfrykt	negative	1
gjesp	negative	1
gjespende	negative	1
lengtende	negative	1
lengsel	positive	1
kjef	negative	1
gule	negative	1
hjelp	negative	1
unge	positive	1
yngre	positive	1
ungdoms	positive	1
ivrig	positive	1
ivrig	positive	1
glød	positive	1
zip	negative	1
